'em  -  'Эм
able  -  в состоянии
about  -  около
acceptable  -  приемлемо
act  -  акт
actual  -  фактический
addict  -  наркоман
adis  -  Адис
admit  -  признавать
after  -  после
afterwards  -  впоследствии
again  -  еще раз
against  -  против
ago  -  тому назад
ahoy  -  на палубе
all  -  все
almost  -  почти
alone  -  в одиночестве
already  -  уже
also  -  также
always  -  всегда
am  -  я
amateur  -  любитель
analysis  -  анализ
and  -  а также
angel  -  ангел
animals  -  животные
another  -  другой
any  -  Любые
anybody  -  кто-нибудь
anyone  -  кто угодно
anything  -  что-нибудь
appropriate  -  подходящее
approve  -  одобрить
aren't  -  не
around  -  вокруг
arrested  -  арестованный
artery  -  артерия
artist  -  художник
as  -  в виде
asleep  -  спящий
ass  -  жопа
asshole  -  Мудак
asskissing  -  asskissing
at  -  в
autopsy  -  вскрытие трупа
avoid  -  избежать
back  -  назад
bad  -  Плохо
bam  -  бам
banker  -  банкир
bar  -  бар
barking  -  лай
bastard  -  Ублюдок
be  -  быть
beams  -  балки
beautiful  -  красивая
because  -  потому как
becomes  -  становится
before  -  до
beg  -  очень прошу
being  -  являющийся
belong  -  принадлежать
best  -  Лучший
bestia  -  Бестия
better  -  лучше
big  -  большой
bigger  -  больше
billups  -  Биллапс
bit  -  немного
bits  -  биты
blade  -  лопасть
blame  -  вина
blew  -  дул
blood  -  кровь
bloodbath  -  бойня
bloodless  -  бескровный
boat  -  лодка
body  -  тело
body's  -  организма
bone  -  кость
bones  -  скелет
boning  -  обвалки
both  -  и то и другое
bother  -  беспокоить
bounce  -  подпрыгивать
boy  -  мальчик
boyfriend  -  дружок
boys  -  мальчиков
briefing  -  брифинг
bring  -  приносить
bris  -  Бри
bro  -  братан
broward  -  Бровард
brunette  -  брюнетка
buddy's  -  Бадди
building  -  здание
bullshit  -  бред сивой кобылы
burden  -  бремя
business  -  бизнес
but  -  но
by  -  от
bye  -  пока
call  -  вызов
can  -  Можно
cards  -  карты
care  -  забота
career  -  карьера
careful  -  осторожный
carotid  -  сонная артерия
carpool  -  совместно пользоваться автомобилем
case  -  дело
catch  -  поймать
cause  -  причина
cell  -  клетка
certainly  -  безусловно
chance  -  шанс
change  -  изменение
changed  -  изменено
changing  -  изменения
channel  -  канал
chaos  -  хаос
charming  -  обаятельный
check  -  проверить
cheese  -  сыр
chef  -  шеф-повар
chick  -  цыпленок
child's  -  Дети
children  -  дети
chocolate  -  шоколад
choice  -  выбор
choir  -  хор
chopped  -  рубленый
christ  -  Христос
clean  -  чистый
close  -  Закрыть
clothes  -  одежда
cocaine  -  кокаин
code  -  код
cody  -  Коди
coffee  -  кофе
coincidence  -  совпадение
cokehead  -  cokehead
cold  -  холодно
collection  -  коллекция
colleen's  -  Коллин
come  -  приехать
completely  -  полностью
completo  -  Полное
concentrate  -  концентрат
confidence  -  уверенность
congrats  -  Поздравляю
control  -  контроль
copper  -  медь
corner  -  угол
coroner  -  коронер
cos  -  соз
couch  -  диван
could  -  мог
couple  -  пара
course  -  курс
cover  -  обложка
covered  -  покрытый
crack  -  трещина
craft  -  ремесло
crayon  -  пастель
creative  -  творческий
creep  -  ползать
creeps  -  ползает
crime  -  преступление
cry  -  плакать
crying  -  плач
crystallization  -  кристаллизация
cuban  -  кубинский
cut  -  порез
cuts  -  порезы
dahmer  -  Дамер
damage  -  наносить ущерб
damaged  -  поврежденный
dan  -  Дан
daring  -  отважный
date  -  Дата
dating  -  знакомства
daylight  -  дневной свет
de  -  де
dead  -  мертвый
deal  -  по рукам
dealer  -  дилер
deb  -  дебютантка
debra  -  Дебра
deserve  -  заслуживать
detail  -  подробно
detectives  -  детективы
devastated  -  опустошенный
dex  -  Dex
dexter  -  правый
die  -  умереть
differences  -  различия
different  -  другой
direction  -  направление
disappeared  -  исчез
discuss  -  обсуждать
disney  -  дисней
do  -  делать
doakes  -  Доакс
doesn't  -  не
dog  -  собака
dogs  -  собаки
domesticdispute  -  domesticdispute
donovan  -  Донован
door  -  дверь
doris  -  Дорис
doubt  -  сомнение
doughnut  -  пончик
doughnuts  -  пончики
down  -  вниз
drips  -  капает
drive  -  водить машину
driver  -  Водитель
driving  -  вождение
drop  -  падение
dry  -  сухой
duct  -  проток
dumb  -  тупой
dumber  -  тупее
dump  -  свалка
during  -  в течение
early  -  рано
earth  -  Земля
easily  -  без труда
easy  -  легко
eat  -  есть
eating  -  принимать пищу
edge  -  край
either  -  или
else  -  еще
emotion  -  эмоция
employ  -  использовать
empty  -  пустой
end  -  конец
enough  -  достаточно
enters  -  входит
environment  -  Окружающая среда
especially  -  особенно
even  -  даже
evening  -  вечер
ever  -  Когда-либо
every  -  каждый
everything  -  все
evolving  -  эволюционирует
exactly  -  в точку
exboyfriend  -  бывший парень
exceeded  -  превышено
excuse  -  оправдание
exhubby  -  exhubby
experimenting  -  экспериментирование
explain  -  объяснять
eye  -  глаз
eyelids  -  веки
eyes  -  глаза
eyewitness  -  очевидец
face  -  лицо
fact  -  факт
fake  -  не настоящие
families  -  семьи
fast  -  быстро
faster  -  Быстрее
father  -  отец
faulty  -  дефектный
favorite  -  любимый
feel  -  Чувствовать
feeling  -  чувство
feelings  -  чувства
fell  -  упал
few  -  мало
fill  -  заполнить
fills  -  заливка
film  -  фильм
filmmaker  -  кинорежиссер
find  -  найти
finding  -  обнаружение
fine  -  отлично
finger  -  Палец
fingernails  -  ногти
finish  -  Конец
fired  -  уволен
first  -  первый
flayed  -  содрали
flee  -  бежать
flesh  -  плоть
flow  -  течь
flying  -  летающий
follow  -  следовать
followed  -  с последующим
food  -  питание
for  -  для
forbid  -  запретить
forensic  -  судебный
forensics  -  судебно-медицинская экспертиза
foster  -  способствовать
foulmouthed  -  foulmouthed
fourth  -  четвертый
friday  -  пятница
friendly  -  дружелюбный
from  -  из
front  -  фронт
fuck  -  Блядь
fuckin'  -  гребаный
fucking  -  чертов
full  -  полный
game  -  игра
garbage  -  мусор
get  -  получить
gets  -  получает
girl  -  девушка
give  -  дайте
glass  -  стакан
gloves  -  перчатки
go  -  идти
good  -  хорошо
grace  -  Грейс
grave  -  могила
great  -  Великий
grotesque  -  гротеск
ground  -  земля
guards  -  гвардия
guess  -  Угадай
gun  -  пистолет
guy  -  парень
habits  -  привычки
hadn't  -  не имел
hail  -  град
haircut  -  стрижка
hallmarklooking  -  hallmarklooking
hammers  -  молотки
hand  -  рука
handsome  -  красивый
hanging  -  подвешивание
happen  -  случаться
happier  -  счастливее
happy  -  счастливый
hard  -  жесткий
harder  -  Сильнее
harry  -  Гарри
hates  -  ненавидит
have  -  иметь
he  -  он
head  -  глава
heading  -  заголовок
headless  -  Обезглавленный
heart  -  сердце
heavy  -  тяжелый
hefties  -  hefties
hell  -  ад
help  -  Помогите
helps  -  помогает
her  -  ее
here  -  Вот
hey  -  Привет
high  -  высокая
hijo  -  Hijo
him  -  его
his  -  его
hit  -  удар
hold  -  держать
holding  -  держа
hollow  -  полый
home  -  Главная
homicide  -  убийство
hone  -  затачивать
honest  -  честный
hooker  -  проститутка
hookers  -  проститутки
horrible  -  какой ужас
hostile  -  враждебный
hot  -  горячий
hotel  -  Гостиница
how  -  как
human  -  человек
hunches  -  предчувствия
hungry  -  голодный
husband  -  муж
ice  -  лед
icecream  -  мороженое
icetruck  -  icetruck
idea  -  идея
ideas  -  идеи
if  -  если
important  -  важный
in  -  в
incredible  -  неимоверный
initial  -  начальная
input  -  вход
inside  -  внутри
insight  -  в поле зрения
inspiration  -  вдохновение
interactions  -  взаимодействия
interesting  -  интересно
internet  -  интернет
interrupted  -  прерванный
interviewing  -  интервью
into  -  в
intoxicating  -  опьяняющий
introduced  -  введены
invested  -  инвестированный
invite  -  приглашать
it  -  Это
it'll  -  это будет
jamie  -  Джей
jane  -  Джейн
jaworski  -  Яворский
jaworski's  -  Яворский-х
jeez  -  черт побери
jesus  -  Иисус
jewish  -  иудейский
job  -  работа
just  -  просто
keen  -  острый
keep  -  держать
keeps  -  держит
kid  -  дитя
kids  -  Дети
kill  -  убийство
killings  -  убийства
kills  -  убийств
kind  -  своего рода
knife  -  нож
know  -  знать
knows  -  знает
lady  -  леди
laguerta  -  laguerta
laguerta's  -  laguerta-х
laid  -  проложенный
land  -  земельные участки
lane  -  полоса дороги
last  -  последний
late  -  поздно
later  -  позже
lawyer  -  адвокат
lead  -  вести
leaf  -  лист
learn  -  учить
leave  -  оставлять
leaving  -  уход
left  -  оставил
leg  -  ножка
less  -  Меньше
lesson  -  урок
let  -  позволять
lid  -  крышка
lieutenant  -  лейтенант
life  -  жизнь
light  -  легкий
like  -  как
likes  -  нравится
listen  -  Слушать
listens  -  слушает
literature  -  литература
little  -  немного
living  -  живой
long  -  длинный
look  -  смотреть
looked  -  смотрел
lord  -  господин
lose  -  потерять
lot  -  много
lots  -  много
lousy  -  паршивый
love  -  люблю
loved  -  любимый
lovely  -  прекрасный
maid  -  горничная
make  -  делать
makes  -  марки
male  -  мужской
maria  -  Мария
maricn  -  maricn
marlin  -  марлин
married  -  в браке
mary  -  Мэри
master  -  мастер
masters  -  мастера
masuka  -  Масука
mating  -  спаривание
matter  -  дело
matthews  -  Matthews
may  -  май
maybe  -  может быть
me  -  меня
mean  -  имею в виду
means  -  означает
meatpacking  -  мясокомбинат
meeting  -  встреча
melts  -  расплавы
men  -  люди
mental  -  умственный
message  -  сообщение
messy  -  беспорядочный
met  -  встретил
meter  -  метр
miami  -  майами
might  -  мог бы
mike  -  Майк
mind  -  разум
minute  -  минут
miss  -  Мисс
mobile  -  мобильный
mom  -  Мама
mom's  -  мама
mommy  -  мамочка
mommy's  -  Мамочка
mondays  -  понедельники
money  -  Деньги
monster  -  монстр
months  -  месяцы
morbid  -  патологический
more  -  Больше
morgan  -  Морган
morgans  -  Морганы
morning  -  утро
motel  -  мотель
mother  -  мама
motherfucker  -  ублюдок
motherfucking  -  ублюдок
movie  -  кино
moving  -  перемещение
mrs  -  Г-жа
much  -  много
murders  -  убийства
must  -  должен
my  -  мой
myself  -  себя
name  -  имя
near  -  возле
neat  -  аккуратный
neater  -  аккуратнее
neatlooking  -  neatlooking
neatly  -  аккуратно
necessary  -  необходимо
need  -  необходимость
needless  -  Излишне
needs  -  потребности
neighborhood  -  окрестности
nephew's  -  племянника
nephews  -  племянники
never  -  никогда
new  -  новый
next  -  следующий
nice  -  хороший
nieces  -  племянницы
night  -  ночь
nights  -  ночью
no  -  нет
noisy  -  шумный
normal  -  нормальный
not  -  не
nothing  -  ничего
notice  -  уведомление
noticed  -  заметил
now  -  Теперь
nuts  -  орешки
odd  -  странный
of  -  из
off  -  от
office  -  офис
officer  -  сотрудник
oh  -  ой
ok  -  ОК
okeydoke  -  okeydoke
on  -  на
one  -  один
only  -  только
open  -  открытый
or  -  или
other  -  Другие
otherwise  -  в противном случае
our  -  наш
out  -  вне
outfit  -  снаряжение
over  -  над
overlooked  -  упускать из виду
own  -  своя
packed  -  уплотненный
painting  -  картина
particular  -  конкретный
parts  -  части
party  -  вечеринка
passion  -  страсть
pattern  -  шаблон
people  -  люди
perfect  -  идеально
person  -  человек
personal  -  личный
pick  -  выбирать
picked  -  выбрал
pieces  -  куски
place  -  место
play  -  играть
pleasant  -  приятный
please  -  пожалуйста
plumbing  -  водопровод
plunged  -  погрузилась
police  -  полиция
politics  -  политика
polluting  -  загрязняющий
pond  -  пруд
pool  -  бассейн
pop  -  поп
pork  -  свинина
porter  -  портье
position  -  должность
possible  -  возможное
power  -  мощность
preparation  -  подготовка
pretty  -  Симпатичная
prints  -  печать
probably  -  вероятно
problem  -  проблема
professional  -  профессиональный
project  -  проект
proves  -  доказывает
psycho  -  псих
public  -  общественности
publicly  -  публично
push  -  От себя
put  -  положил
puta  -  пута
question  -  вопрос
quick  -  быстро
quiet  -  тихо
raft  -  рафт
raising  -  привлечение
rape  -  изнасилование
raped  -  изнасилованная
rate  -  ставка
read  -  читать
ready  -  готов
real  -  реальный
really  -  действительно
reasonable  -  разумный
recognize  -  признать
recognizes  -  признает
refrigerated  -  охлажденный
relationship  -  отношения
remember  -  запомнить
repeatedly  -  неоднократно
report  -  доклад
rid  -  избавиться
right  -  правильно
rita  -  Рита
rita's  -  Риты
ritual  -  ритуал
rituals  -  ритуалы
rival  -  соперник
room  -  комната
rubber  -  ластик
ruler  -  линейка
running  -  Бег
sacrifice  -  жертва
safety  -  безопасность
salt  -  поваренная соль
same  -  одна и та же
sandwiches  -  бутерброды
satisfied  -  доволен
saunders  -  Сондерс
savage  -  дикарь
saved  -  сохранены
say  -  сказать
saying  -  поговорка
scene  -  место действия
scream  -  орать
scribble  -  мазня
scumbags  -  отморозки
search  -  поиск
seas  -  моря
seat  -  сиденье
sec  -  сек
section  -  раздел
security  -  безопасность
see  -  видеть
sense  -  смысл
sensibility  -  обидчивость
sergeant  -  сержант
sets  -  наборы
settle  -  селиться
seven  -  семь
severing  -  разрывающий
sex  -  секс
shame  -  позор
shape  -  форма
share  -  доля
sharp  -  острый
she  -  она
she'd  -  сарай
sheets  -  простыни
shit  -  дерьмо
shithole  -  дыра
should  -  должен
shoulder  -  плечо
show  -  показать
shut  -  закрыть
shuttle  -  челнок
sidewalk  -  тротуар
sight  -  взгляд
since  -  поскольку
sister  -  сестра
sites  -  места
six  -  шесть
skin  -  кожа
slashed  -  полоснул
sleep  -  спать
slept  -  спала
slices  -  ломтики
slicing  -  нарезка
slide  -  горка
slow  -  медленный
slows  -  замедляет
small  -  маленький
smart  -  умная
smarter  -  умнее
smash  -  громить
snuff  -  нюхательный табак
so  -  так
socially  -  социально
solve  -  решать
some  -  некоторые
somebody  -  кто-то
someone  -  кто то
something  -  что нибудь
sometime  -  когда-то
sometimes  -  иногда
son  -  сын
soon  -  скоро
sorry  -  Прости
soul  -  душа
sound  -  звук
space  -  пространство
spatter  -  брызгать
splashes  -  брызги
spot  -  место
sprays  -  спреи
stab  -  удар ножом
stack  -  стек
staged  -  поставил
standards  -  стандарты
standing  -  постоянный
start  -  Начало
state  -  государство
stay  -  оставаться
steal  -  украсть
sticks  -  палочки
sticky  -  липкий
still  -  все еще
stole  -  украл
stolen  -  похищенный
stop  -  стоп
stopped  -  остановился
story  -  история
strange  -  странный
strawberry  -  клубника
stronger  -  сильнее
successful  -  успешный
such  -  такие
sue  -  Сью
suit  -  костюм
supposed  -  предполагаемый
supposedly  -  предположительно
sure  -  конечно
sushi  -  суши
suspects  -  подозреваемые
sweet  -  милая
sweetie  -  милая
sword  -  меч
tailgate  -  задний откидной борт
take  -  принимать
talk  -  говорить
tape  -  лента
taste  -  вкус
taught  -  учил
teach  -  учат
technique  -  техника
teeth  -  зубы
tell  -  рассказать
tells  -  говорит
texas  -  Техас
than  -  чем
thanks  -  благодаря
that  -  что
that's  -  это
the  -  the
their  -  их
them  -  их
then  -  тогда
theory  -  теория
there  -  там
these  -  эти
they  -  Oни
thick  -  толстый
thief  -  вор
thing  -  вещь
think  -  думать
thinking  -  мышление
third  -  в третьих
this  -  это
those  -  те
thought  -  думал
three  -  три
threw  -  бросил
through  -  через
throw  -  бросать
thursdays  -  по четвергам
tight  -  в обтяжку
time  -  время
tired  -  устала
tissue  -  ткань
tits  -  сиськи
to  -  в
today  -  Cегодня
together  -  вместе
tomorrow  -  завтра
tonight's  -  сегодня вечером
too  -  слишком
tools  -  инструменты
top  -  Вверх
touch  -  потрогать
town  -  город
track  -  трек
tracked  -  отслеживаются
trade  -  сделка
transfer  -  перевод
truck  -  грузовая машина
trucks  -  грузовики
true  -  правда
truth  -  правда
try  -  пытаться
turn  -  очередь
turning  -  превращение
two  -  два
types  -  типы
under  -  под
understand  -  Понимаю
understanding  -  понимание
undignified  -  недостойный
unfortunately  -  К сожалению
uninterested  -  незаинтересованный
unique  -  уникальный
unless  -  если
until  -  до
unusual  -  необычный
up  -  вверх
upset  -  рассториться
urge  -  побуждать
urges  -  позывы
us  -  нас
use  -  использование
valet  -  камердинер
vanilla  -  ваниль
vehicle  -  средство передвижения
very  -  очень
vice  -  вице
victim  -  жертва
violated  -  нарушаться
violent  -  насильственный
vital  -  жизненно важно
wait  -  Подождите
waiting  -  ожидание
walls  -  стены
want  -  хотеть
wants  -  хочет
warrant  -  варрант
waste  -  отходы
way  -  путь
we  -  мы
we'll  -  Что ж
website  -  Веб-сайт
week  -  неделю
weird  -  странный
weirdest  -  странное
weirdo  -  чудак
welcome  -  добро пожаловать
well  -  Что ж
wham  -  бам
what  -  какие
whatever  -  без разницы
wheel  -  колесо
when  -  когда
whenever  -  всякий раз, когда
where  -  где
which  -  который
while  -  в то время как
who  -  кто
whore  -  шлюха
why  -  Зачем
will  -  будем
wish  -  желание
with  -  с
without  -  без
witness  -  свидетель
woman  -  женщина
women  -  женщины
wonderful  -  замечательно
work  -  Работа
worked  -  работал
works  -  работает
world  -  Мир
worried  -  волновался
worse  -  хуже
would  -  бы
wrap  -  заворачивать
wrapped  -  завернутый
write  -  записывать
wrong  -  неправильно
yapping  -  тявкать
yeah  -  Да
yes  -  да
yet  -  все же
you  -  вы
your  -  ваш
yours  -  ваш
