abducts  -  похищает
abilities  -  способности
accross  -  accross
adoption  -  принятие
advance  -  продвижение
agency  -  агентство
agents  -  агенты
alert  -  бдительный
alley  -  аллея
amber  -  янтарный
an  -  an
antique  -  античный
apart  -  Кроме
are  -  находятся
arrest  -  арестовывать
asked  -  спросил
asking  -  просить
assigned  -  назначенный
attempts  -  попытки
awful  -  ужасный
backpack  -  рюкзак
barstow  -  Барстоу
bathroom  -  ванная
been  -  было
began  -  начал
behalf  -  от имени
believed  -  Считается,
bend  -  изгиб
bennett  -  беннетт
bid  -  предложение
bitch  -  сука
bluster  -  бушевать
borrow  -  заимствовать
boys'  -  мальчиков
breaks  -  брейки
breather  -  сапун
britney  -  бритни
buddy  -  дружище
bugs  -  ошибки
burns  -  ожоги
busted  -  лопнул
butchered  -  разделывали
cab  -  такси
called  -  называется
calls  -  звонки
came  -  пришел
can't  -  не может
cannot  -  не могу
capable  -  способный
captain  -  капитан
carried  -  осуществляется
caught  -  пойманный
chandra  -  чандра
changes  -  изменения
chapter  -  глава
checked  -  проверено
cheerleader  -  болельщик
cheerleaders  -  болельщиц
cheerleading  -  черлидинг
cia  -  CIA
claire  -  Claire
climbed  -  поднялся
closer  -  ближе
cockroaches  -  тараканы
colorffff  -  colorffff
comes  -  выходит
coming  -  приход
committed  -  привержен
condescending  -  снисходительный
conencted  -  conencted
congratulate  -  поздравлять
constantly  -  постоянно
continues  -  продолжается
continuum  -  континуум
contrary  -  вопреки
cooking  -  Готовка
cop  -  полицейский
cops  -  менты
copy  -  копия
correct  -  верный
cough  -  кашель
couldn't  -  не может
counseling  -  консультирование
couples  -  пары
courage  -  мужество
crazy  -  псих
criminal  -  преступник
dad  -  папа
dad's  -  папа
daddy  -  папа
dainty  -  лакомство
damn  -  черт
darwin's  -  Дарвина
days  -  дней
decided  -  приняли решение
definitely  -  определенно
delusions  -  мании
depression  -  депрессия
depressive  -  депрессивный
destiny  -  судьба
details  -  Детали
detective  -  детектив
determining  -  определения
diagnosed  -  диагностированы
did  -  сделал
didn't  -  не
died  -  умер
discovering  -  обнаружение
disorder  -  расстройство
dl  -  дл
dna  -  ДНК
does  -  делает
doing  -  дела
don't  -  не
done  -  сделанный
dressed  -  заправленный
drugs  -  наркотики
dying  -  умирающий
ears  -  уши
eccentric  -  эксцентричный
edition  -  издание
embarrassed  -  смущенный
emi  -  ЭМИ
emotionally  -  эмоционально
english  -  английский
entitled  -  озаглавленный
erection  -  монтаж
escape  -  побег
everybody's  -  все это
everyone's  -  все это
everywhere  -  везде
evolution  -  эволюция
exam  -  экзамен
except  -  Кроме
explosion  -  взрыв
exterminator  -  уничтожитель
extraordinary  -  необычайный
falling  -  падение
fate  -  судьба
father's  -  отец
fbi  -  ФБР
feet  -  ноги
finds  -  находки
finishing  -  отделка
firefighter  -  пожарный
firemen  -  пожарников
flew  -  полетела
floorboards  -  половицы
flunking  -  завалил
flush  -  промывать
font  -  шрифт
forced  -  принудительный
forever  -  навсегда
forgot  -  забыл
fought  -  дрался
found  -  найденный
freaked  -  испещренный
freeze  -  замерзать
friends  -  друзья
frozen  -  замороженный
fun  -  весело
funny  -  веселая
garage  -  гараж
genetic  -  генетический
genomes  -  геномы
getting  -  получение
girl's  -  девичий
girls  -  девочки
glad  -  довольный
globe  -  земной шар
god  -  Бог
going  -  собирается
gone  -  прошло
gonna  -  собирается
goodbye  -  Прощай
got  -  получил
gotta  -  должен
gotten  -  полученный
grab  -  грейфер
grand  -  большой
grandeur  -  грандиозность
grateful  -  благодарный
grew  -  вырос
guy's  -  парень
guys  -  парни
had  -  имел
hands  -  Руки
happened  -  получилось
happens  -  происходит
has  -  имеет
hasn't  -  не имеет
having  -  имеющий
he'd  -  он
he'll  -  ад
he's  -  он
heard  -  услышанным
hello  -  Здравствуйте
helped  -  помог
here's  -  вот
hero  -  герой
heroes  -  герои
heroin  -  героин
hi  -  Здравствуй
hiro  -  Хиро
hiroshima  -  Хиросима
hobbies  -  увлечения
holster  -  кобура
homeland  -  Родина
hon  -  хон
honey  -  мед
honor  -  честь
honorary  -  почетный
hoped  -  надеялся
hoping  -  надеясь
hours  -  часов
huh  -  хм
hunger  -  голод
hurry  -  торопиться
i'd  -  Я бы
i'll  -  больной
i'm  -  я
i've  -  я
id  -  Я бы
indestructible  -  нерушимый
indulge  -  баловать
infested  -  зараженные паразиты
intervenes  -  вмешивается
investigation  -  расследование
invincible  -  непобедимый
irrational  -  иррациональный
is  -  является
isaac  -  Исаак
isn't  -  не
issued  -  выпущен
issues  -  вопросы
it's  -  его
jackie  -  Jackie
jumped  -  прыгнули
keeping  -  хранение
kick  -  удар
killed  -  убитый
killer  -  убийца
killing  -  убийство
kiss  -  поцелуй
knew  -  знал
knocked  -  нокаутировал
la  -  ля
larger  -  больше
lengthy  -  длинный
let's  -  Давайте
library  -  библиотека
lied  -  солгал
linderman  -  Линдерман
link  -  ссылка
lizard  -  ящерица
locker  -  рундук
longer  -  дольше
looking  -  Ищу
looks  -  выглядит
loose  -  свободный
lost  -  потерял
loves  -  любит
luck  -  везение
lucky  -  везучий
lungs  -  легкие
lying  -  лежащий
ma'am  -  сударыня
made  -  сделал
madras  -  хлопчатобумажная ткань в полоску
making  -  изготовление
man's  -  мужской
marching  -  походный
marshall  -  маршал
marvel  -  диво
mathematical  -  математическая
meant  -  имел ввиду
mendez  -  Mendez
merry  -  веселый
messages  -  Сообщения
micah  -  Михей
migration  -  миграция
mikey  -  Mikey
mine  -  мой
minutes  -  минут
mirror  -  зеркало
missing  -  отсутствует
mohinder  -  Мохиндер
momare  -  momare
mr  -  Мистер
murdered  -  убитый
murderer  -  убийца
mystery  -  тайна
nah  -  Неа
nakamura  -  Накамура
named  -  названный
nathan  -  Натан
niki  -  Niki
nope  -  Неа
november  -  ноябрь
october  -  октябрь
odessa  -  Одесса
ones  -  те,
origin  -  происхождения
ourselves  -  сами
overdosed  -  передозировка
ow  -  вл
pack  -  пак
painted  -  окрашенный
pal  -  собутыльник
papa  -  папа
parade  -  парад
paranoid  -  параноик
parents  -  родители
parkman  -  Parkman
passport  -  заграничный пасспорт
patterns  -  узоры
pete  -  Пит
peter  -  Питер
petrelli  -  Петрелли
pioneer  -  пионер
played  -  играл
pone  -  сдоба
portable  -  портативный
posted  -  отправил
pregnant  -  беременная
previously  -  предварительно
priority  -  приоритет
problems  -  проблемы
professor's  -  профессорский
protecting  -  защищающий
province  -  провинция
pulled  -  вытащил
questions  -  вопросов
raceman  -  raceman
reached  -  достиг
realized  -  понял
reluctant  -  неохотный
reputation  -  репутации
request  -  запрос
rescue  -  спасение
roof  -  крыша
rough  -  грубый
sad  -  грустный
said  -  сказал
saresh  -  saresh
saresh's  -  saresh-х
saving  -  экономия
saw  -  увидел
sawed  -  пилили
says  -  говорит
schoollike  -  schoollike
scores  -  множество
scratch  -  царапина
screw  -  винт
seconds  -  секунд
secrets  -  секреты
seeing  -  видя
seeks  -  стремится
seemed  -  казалось
seems  -  кажется
seen  -  видели
sensitive  -  чувствительный
serial  -  последовательный
she's  -  она
sheet  -  лист
sheriff  -  шериф
shh  -  тсс
shortcut  -  сокращенный
siberia  -  Сибирь
sick  -  больной
simone  -  Симона
sizewwwtvsubtitlesnetfont  -  sizewwwtvsubtitlesnetfont
skills  -  навыки
skull  -  череп
smoke  -  дым
snap  -  щелчок
solid  -  твердый
someplace  -  где-то
spacetime  -  пространство-время
speaking  -  Говорящий
spears  -  копья
splattered  -  забрызгали
spoke  -  говорил
spraying  -  распыление
st  -  улица
started  -  начал
stealing  -  кража
strangers  -  незнакомцы
strikes  -  забастовки
suicidal  -  самоубийственный
suicide  -  самоубийство
super  -  супер
suppose  -  предполагать
suresh  -  Суреш
surrounded  -  окруженный
surrounding  -  окружающих
sweetheart  -  возлюбленная
sylar  -  Sylar
synchro  -  синхро
taken  -  взятый
taker  -  берущий
takes  -  принимает
taking  -  принятие
talked  -  говорили
talking  -  говорящий
tap  -  нажмите
teleport  -  телепорт
teleported  -  телепортировался
telling  -  говоря
terrible  -  ужасный
th  -  го
theorem  -  теорема
theories  -  теории
therapy  -  терапия
there's  -  есть
they're  -  они
things  -  вещи
thoughtful  -  Вдумчивый
thoughts  -  мысли
times  -  раз
toilet  -  туалет
told  -  сказал
took  -  взял
tracks  -  треков
transcript  -  расшифровка
travis  -  Трэвис
treacherous  -  вероломный
trek  -  путешествие
treks  -  походы
tried  -  пытался
triumph  -  триумф
truly  -  действительно
trunk  -  хобот
trust  -  доверять
trying  -  пытаясь
turns  -  витки
uh  -  эм
um  -  гм
uniform  -  единообразный
union  -  союз
urgent  -  срочный
used  -  используемый
using  -  с помощью
vacation  -  отпуск
videotape  -  видеокассета
wanna  -  хочу
wanted  -  разыскивается
wanting  -  желая
warn  -  предупреждать
was  -  был
wasn't  -  не было
watched  -  смотрели
watching  -  наблюдение
we're  -  мы
we've  -  мы в
weeks  -  недель
wells  -  углубления
were  -  мы
whassup  -  Whassup
what's  -  какой
where'd  -  где D
whisper  -  шептать
whispering  -  шепот
who'd  -  кто бы
who's  -  кто
whoa  -  тпру
whoo  -  Охайте
wiped  -  стер
woke  -  просыпался
won't  -  не будет
wondered  -  задавались вопросом
wondering  -  интересно
words  -  слова
working  -  за работой
worklike  -  worklike
worthless  -  бесполезный
wouldn't  -  не будет
wound  -  рана
wow  -  Вау
wraps  -  обертывания
wreck  -  развалина
wreckage  -  обломки судна
wwwforomcom  -  wwwforomcom
yankees  -  янкиз
yatai  -  Ятаи
years  -  лет
york  -  йорк
york's  -  Йорк
you'd  -  вы бы
you'll  -  Вы будете
you're  -  Вы
you've  -  вы имеете
zach  -  Zach
zero  -  нуль
