'ead  -  «EAD
'em  -  'Эм
'ere  -  «до
abducted  -  похищена
abroad  -  за границу
acclimatised  -  акклиматизированы
accommodation  -  жилье
actual  -  фактический
addict  -  наркоман
addicted  -  склонный
adjust  -  регулировать
afford  -  позволить себе
afghanistan  -  Афганистан
ages  -  возраст
aggressive  -  агрессивный
ah  -  ах
ain't  -  не
airline  -  авиакомпания
alarming  -  тревожный
alcohol  -  алкоголь
alcoholic  -  алкоголик
alibi  -  алиби
aloud  -  вслух
amateurs  -  любители
amazing  -  удивительно
an  -  an
anderson  -  андерсон
anderson's  -  Андерсон
aneurism  -  аневризма
angelo  -  Анжело
announcement  -  объявление
annoying  -  раздражающий
anthea  -  Антея
anywhere  -  в любом месте
apparent  -  очевидный
appearances  -  Выступления
applause  -  аплодисменты
appreciation  -  признательность
approve  -  одобрить
archenemies  -  заклятые враги
archenemy  -  заклятый враг
are  -  находятся
aren't  -  не
arrived  -  прибывший
asked  -  спросил
asking  -  просить
asphyxiation  -  удушение
assistant  -  помощник
association  -  ассоциация
assuming  -  при условии,
assumption  -  предположение
attachment  -  прикрепление
attracts  -  привлекает
avoiding  -  избегая
awful  -  ужасный
backstreet  -  подпольный
baker  -  пекарь
barely  -  едва
barts  -  Barts
battery  -  аккумулятор
battlefield  -  поле битвы
beaten  -  избитый
bedroom  -  Спальня
bedrooms  -  спальни
bee  -  пчела
been  -  было
belonged  -  принадлежал
bet  -  делать ставку
beth  -  в промежутке
biding  -  выжидать
billy  -  Билли
biscuits  -  печенье
bit's  -  бИТ
bitter  -  горький
bitterness  -  горечь
blacked  -  затемненными
blanket  -  одеяло
blog  -  блог
bloody  -  кровавый
bluff  -  утес
blunder  -  просчет
bored  -  скучающий
boring  -  скучный
borrow  -  заимствовать
boss  -  босс
bother  -  беспокоить
bottle  -  бутылка
bottles  -  бутылки
boyfriend  -  дружок
boyfriends  -  бойфрендов
brains  -  мозги
branch  -  филиал
bravery  -  храбрость
breaking  -  ломка
breathe  -  дышать
breathing  -  дыхание
breathing's  -  дыхание-х
brilliant  -  блестящий
bringing  -  приведение
brixton  -  Брикстон
brother's  -  брат
brought  -  привел
bruises  -  ушибы
bulky  -  объемистый
bullet  -  пуля
bully  -  задира
burns  -  ожоги
bust  -  бюст
busy  -  занятый
bye  -  пока
cab  -  такси
cabbie  -  извозчик
cabbie's  -  таксист-х
cabi  -  CABI
cabs  -  кэбы
calf  -  теленок
californian  -  калифорниец
called  -  называется
came  -  пришел
can't  -  не может
candle  -  свеча
capable  -  способный
cardiff  -  Кардифф
cards  -  карты
careful  -  осторожный
cares  -  заботы
cari  -  чари
cars  -  легковые автомобили
caught  -  пойманный
causes  -  причины
chances  -  шансы
changes  -  изменения
chasing  -  погоня
chat  -  чат
chatter  -  болтовня
cheap  -  дешево
cheat  -  мошенничать
checked  -  проверено
chess  -  шахматы
child's  -  Дети
childish  -  детский
children  -  дети
choked  -  подавился
chooses  -  выбирает
christmas  -  рождество
cia  -  CIA
circumstances  -  обстоятельства
civilian  -  гражданский
clara  -  Клара
cleaned  -  очищенный
cleaners  -  очистители
cleared  -  очищается
clever  -  умная
cleverer  -  умней
closely  -  тесно
closest  -  ближайший
clothesconscious  -  clothesconscious
coat  -  Пальто
coins  -  монеты
collar  -  воротник
colorffff  -  colorffff
colorffffa  -  colorffffa
colorfffforiginal  -  colorfffforiginal
colorfffsherlock  -  colorfffsherlock
colourcoordinates  -  colourcoordinates
coming  -  приход
commit  -  совершить
compelled  -  вынужденный
confession  -  признание
confirm  -  подтвердить
constantly  -  постоянно
consult  -  советоваться
consulting  -  консалтинг
contaminated  -  загрязненный
cookies  -  печенье
coppers  -  медяков
correctly  -  правильно
cos  -  соз
couldn't  -  не может
cousin  -  двоюродная сестра
crack  -  трещина
cracked  -  треснувший
crimes  -  преступления
criminal  -  преступник
crop  -  культура
crossing  -  скрещивание
crowded  -  переполненный
cuppa  -  чашка чаю
damn  -  черт
damp  -  сырость
dancing  -  танцы
dash  -  тир
dashing  -  лихой
daughter's  -  дочери
davenport  -  тахта
days  -  дней
dealing  -  дело
dear  -  Уважаемые
deaths  -  смертей
decent  -  порядочный
decided  -  приняли решение
deduction  -  вычет
deeper  -  Глубже
definitely  -  определенно
deodorant  -  дезодорант
depends  -  зависит
depth  -  глубина
designer  -  дизайнер
desperate  -  отчаянный
destination  -  место назначения
details  -  Детали
detective  -  детектив
detectives  -  детективы
did  -  сделал
didn't  -  не
died  -  умер
dim  -  тусклый
dinners  -  обеды
disappeared  -  исчез
discreet  -  сдержанный
disorder  -  расстройство
dispose  -  располагать
distracting  -  отвлекающий
divorce  -  развод
does  -  делает
doesn't  -  не
doing  -  дела
don't  -  не
done  -  сделанный
donovan  -  Донован
door's  -  дверь
doorbell  -  дверной звонок
double  -  двойной
doubt  -  сомнение
downstairs  -  вниз по лестнице
dr  -  доктор
dragging  -  перетаскивание
dramatic  -  драматичный
drawing  -  Рисование
dreadful  -  ужасный
dried  -  высушенный
drinker  -  пьющий
drinking  -  питьевой
driven  -  управляемый
driving  -  вождение
drove  -  поехали
drugs  -  наркотики
drunk's  -  пьяны-х
dug  -  выкопанный
dull  -  скучный
dying  -  умирающий
earlier  -  ранее
ease  -  легкость
elsewhere  -  в другом месте
email  -  Эл. адрес
emails  -  электронная почта
emergency  -  крайняя необходимость
enabled  -  включен
enemies  -  враги
engraving  -  гравюра
ensured  -  обеспечена
entered  -  вошел
er  -  эр
erm  -  эм
estranged  -  раздельно проживающий
everyone's  -  все это
evidence  -  доказательства
excellent  -  отлично
except  -  Кроме
executed  -  выполненный
expecting  -  ожидая
expense  -  расходы
experiment  -  эксперимент
explaining  -  объясняя
extended  -  расширенный
extraordinary  -  необычайный
eyes  -  глаза
faintest  -  тусклых
fantastic  -  фантастика
favour  -  благоприятствовать
favourite  -  любимый
fee  -  плата
fell  -  упал
fellow  -  человек
feud  -  междоусобица
fiction  -  фантастика
fighter  -  истребитель
filling  -  заполнение
fingernails  -  ногти
fingers  -  пальцы
finished  -  законченный
fiveminute  -  fiveminute
flat  -  квартира
flatmate  -  сосед
flatmates  -  соседи по квартире
flatshare  -  Flatshare
flattered  -  польщен
flesh  -  плоть
floors  -  этажей
florida  -  Флорида
foam  -  пена
font  -  шрифт
forensics  -  судебно-медицинская экспертиза
forgot  -  забыл
forgotten  -  забытый
fortune  -  состояние
found  -  найденный
fourteen  -  14
frailty  -  хрупкость
frame's  -  фрейма
frankly  -  Откровенно
freak  -  урод
freak's  -  фрик-х
freelance  -  внештатно
friends  -  друзья
frightening  -  пугающий
fun  -  весело
funnily  -  смешно
funny  -  веселая
further  -  в дальнейшем
gadget  -  приспособление
gardens  -  сады
gave  -  дал
genius  -  гениальность
german  -  Немецкий
gets  -  получает
getting  -  получение
giggle  -  хихикать
girlfriend  -  Подруга
girlfriends  -  подружки
given  -  данный
giving  -  дающий
god  -  Бог
god's  -  божий
goes  -  идет
going  -  собирается
gone  -  прошло
goodness'  -  благость
goodnight  -  доброй ночи
got  -  получил
gps  -  GPS
greater  -  большая
guessing  -  угадывание
gunpoint  -  дуло пистолета
guys  -  парни
habit  -  привычка
habits  -  привычки
had  -  имел
haircut  -  стрижка
handgun  -  пистолет
hands  -  Руки
happened  -  получилось
happening  -  происходит
happens  -  происходит
happily  -  счастливо
harriet  -  Харриет
harry  -  Гарри
harry's  -  Гарри
has  -  имеет
hasn't  -  не имеет
haunted  -  часто посещаемый
haven't  -  не
having  -  имеющий
he'd  -  он
he'll  -  ад
he's  -  он
heard  -  услышанным
hearing  -  слух
heel  -  пятка
hei  -  хей
helicopter  -  вертолет
hello  -  Здравствуйте
helping  -  помощь
helps  -  помогает
hence  -  следовательно
herbal  -  травяной
hero  -  герой
hi  -  Здравствуй
highfunctioning  -  highfunctioning
hip  -  тазобедренный
hm  -  гм
holmes  -  холмс
honestly  -  честно говоря
hoping  -  надеясь
hours  -  часов
housebreaking  -  взлом дома
housekeeper  -  экономка
houston  -  Хьюстон
how's  -  как это
hudson  -  Гудзон
hudson's  -  Хадсона
hungry  -  голодный
hunting  -  охота
hunts  -  охотится
hurry  -  торопиться
hurting  -  больно
hurts  -  болит
i'd  -  Я бы
i'll  -  больной
i'm  -  я
i'mcalling  -  Я зову
i've  -  я
iand  -  я и
iarei  -  iarei
identical  -  идентичный
ididi  -  ididi
idiot  -  идиот
idiots  -  идиоты
ido  -  я делаю
idoesi  -  idoesi
idoi  -  idoi
ieveri  -  ieveri
ifacei  -  ifacei
iget  -  я получил
ihasi  -  ihasi
ihavei  -  ihavei
iheri  -  iheri
ihimi  -  ihimi
ihisi  -  ihisi
ii  -  б
imagination  -  воображение
imakesi  -  imakesi
imei  -  IMEI
immediate  -  немедленный
imply  -  подразумевать
implying  -  подразумевающий
improvement  -  улучшение
incidents  -  инцидентов
indication  -  индикация
indiscreet  -  нескромный
ineedi  -  ineedi
injuries  -  травмы
inowi  -  inowi
input  -  вход
inspector  -  инспектор
intended  -  предназначена
intending  -  намеревающийся
intermittent  -  прерывистый
invaded  -  вторгся
invalided  -  демобилизован
invented  -  изобрел
investigating  -  расследование
investigation  -  расследование
investigations  -  исследования
invisible  -  невидимый
invited  -  приглашенный
ionei  -  ionei
ioni  -  Ioni
iplantedi  -  iplantedi
iq  -  IQ
iraq  -  Ирак
is  -  является
isherlocki  -  isherlocki
isn't  -  не
isomeonei  -  isomeonei
issues  -  вопросы
it'll  -  это будет
it's  -  его
ithere  -  это здесь
ithisi  -  ithisi
iti  -  ити
iveryi  -  iveryi
iwasi  -  iwasi
iwilli  -  iwilli
iyou'rei  -  iyou'rei
iyoui  -  iyoui
james  -  Джеймс
jeffrey  -  Джеффри
jenniepinkmephoneorguk  -  jenniepinkmephoneorguk
jennifer  -  Jennifer
jewellery  -  ювелирные изделия
john  -  Джон
july  -  июль
junior  -  младший
junkie  -  наркоман
kamikaze  -  камикадзе
keen  -  острый
keeping  -  хранение
kept  -  хранится
keys  -  ключи
kicks  -  пинки
kids  -  Дети
killed  -  убитый
killer  -  убийца
killers  -  убийцы
killing  -  убийство
killings  -  убийства
kindest  -  Добрый
kisses  -  поцелуи
knees  -  колени
knew  -  знал
known  -  известен
la  -  ля
label  -  метка
lady's  -  дамский
landlady  -  помещица
landline  -  стационарный
lane  -  полоса дороги
laptop  -  портативный компьютер
laundered  -  отмываются
lauriston  -  Lauriston
leading  -  ведущий
leap  -  прыжок
learns  -  узнает
leaves  -  листья
leaving  -  уход
lefti  -  lefti
lestrade  -  Лестрейд
let's  -  Давайте
letting  -  сдача в аренду
lifetime  -  продолжительность жизни
lights  -  огни
liked  -  понравилось
likes  -  нравится
limp  -  прихрамывать
limp's  -  хромота-х
link  -  ссылка
linked  -  связанный
links  -  связи
lipstick  -  губная помада
lived  -  жил
lives  -  жизни
logical  -  логический
london  -  Лондон
longer  -  дольше
looked  -  смотрел
looking  -  Ищу
losing  -  проигрыш
lost  -  потерял
lots  -  много
loud  -  громкий
loved  -  любимый
lovely  -  прекрасный
lover  -  любовник
lovers  -  любовники
loves  -  любит
lower  -  ниже
loyal  -  верный
ltd  -  ООО
luck  -  везение
lucky  -  везучий
luggage  -  багаж
lunatic  -  помешанный
luxury  -  роскошь
lying  -  лежащий
mad  -  Сумасшедший
made  -  сделал
mail  -  почта
making  -  изготовление
man's  -  мужской
marks  -  Метки
marksman  -  меткий стрелок
mastermind  -  вдохновитель
mate  -  приятель
meaningful  -  значимым
means  -  означает
memories  -  воспоминания
men  -  люди
mentioned  -  упомянутый
menu  -  меню
mess  -  беспорядок
met  -  встретил
microwave  -  микроволновая печь
mike  -  Майк
mine  -  мой
minister  -  министр
minor  -  незначительный
minutes  -  минут
missing  -  отсутствует
mm  -  мм
mmhm  -  mmhm
mmm  -  ммм
mobile  -  мобильный
model's  -  модели
modest  -  скромный
molly  -  Молли
moments  -  моменты
monica  -  Моника
months  -  месяцы
moriarty  -  Мориарти
mortuary  -  морг
mother's  -  мамин
motivation  -  мотивация
motivator  -  мотиватор
mouth's  -  рот-х
moved  -  переехал
mp  -  член парламента
mr  -  Мистер
mrs  -  Г-жа
mummy  -  Мама
murdered  -  убитый
murderer  -  убийца
murders  -  убийства
mycroft  -  Майкрофт
mystery  -  тайна
nah  -  Неа
nails  -  ногти
name's  -  зовут
narrows  -  узкость
needing  -  нуждаясь
needs  -  потребности
neither  -  ни
nerves  -  нервы
nicer  -  лучше
nicotine  -  никотин
nobody's  -  ничей
noone  -  никто
noone's  -  ни один
normally  -  как обычно
northumberland  -  Нортумберленд
notes  -  заметки
noticed  -  заметил
numbers  -  чисел
o'clock  -  час
observed  -  наблюдаемый
occupy  -  оккупировать
oddly  -  странно
one's  -  один это
ones  -  те,
ongoing  -  постоянный
online  -  онлайн
ooh  -  ух
opposite  -  напротив
organisation  -  организация
organiser  -  организатор
ought  -  должен
outlived  -  изжил
overnight  -  с ночевкой
owes  -  должен
paid  -  оплаченный
panic  -  паника
papers  -  документы
paralytic  -  паралитический
partly  -  частично
passed  -  прошло
passenger  -  пассажир
passes  -  проходит
passing  -  прохождение
password  -  пароль
patch  -  пластырь
patches  -  патчи
patterson  -  Patterson
pedestrian  -  пешеход
pension  -  пенсия
perfectly  -  в совершенстве
perhaps  -  возможно
petty  -  мелкий
phillimore  -  Филлимор
photograph  -  фотография
photograph's  -  фотография-х
photographs  -  фотографии
picked  -  выбрал
pickpocket  -  карманник
pill  -  пилюля
pills  -  таблетки
pilot  -  пилот
pink  -  розовый
pinkfont  -  pinkfont
piss  -  ссать
pity  -  жалость
places  -  мест
planning  -  планирование
played  -  играл
playing  -  играть
plenty  -  много
plugs  -  штекеры
pointed  -  заостренный
poison  -  яд
policemen  -  полицейские
polishing  -  полирование
popping  -  выскакивают
posttraumatic  -  Посттравматический
powder  -  порошок
practically  -  практически
precautions  -  меры предосторожности
precisely  -  точно
prefer  -  предпочитать
preliminary  -  предварительный
pretend  -  делать вид
prime  -  простое число
prior  -  предшествующий
probability  -  вероятность
problems  -  проблемы
proper  -  правильный
properly  -  должным образом
proved  -  доказано
proving  -  доказывания
psychopath  -  психопат
psychopaths  -  психопаты
psychosomatic  -  психосоматический
publicspirited  -  publicspirited
putting  -  сдачи
questions  -  вопросов
rache  -  Rache
rachel  -  Рахиль
radius  -  радиус
realise  -  понимать
realised  -  понял
reasonable  -  разумный
reasons  -  причины
receives  -  получает
recognised  -  признанное
recreational  -  развлекательный
reference  -  Справка
refreshed  -  обновилась
regularly  -  регулярно
relax  -  расслабиться
relaxing  -  расслабляющий
remarkable  -  замечательный
rent  -  аренда
resembles  -  походит
resentful  -  обиженный
returning  -  возврате
revenge  -  жажда мести
rid  -  избавиться
ridiculous  -  смешной
riding  -  верховая езда
righti  -  righti
ring  -  кольцо
ringing  -  звонкий
rings  -  кольца
risked  -  рисковала
risky  -  рискованный
roadworks  -  дорожные работы
rolandkerr  -  rolandkerr
romantic  -  романтик
round  -  круглый
route  -  маршрут
row  -  ряд
rubbish  -  мусор
ruddy  -  румяный
running  -  Бег
said  -  сказал
sake  -  ради
sally  -  Салли
santa  -  Санта
saw  -  увидел
saying  -  поговорка
says  -  говорит
scratched  -  поцарапан
scratches  -  царапины
scrubbed  -  шероховатый
scuff  -  протереться
seconds  -  секунд
secret  -  секрет
seeing  -  видя
seen  -  видели
seizure  -  захват
selfadministered  -  selfadministered
sent  -  послал
sentenced  -  приговоренный
sentiment  -  настроение
sergeant  -  сержант
serial  -  последовательный
seriously  -  шутки в сторону
shade  -  тень
shaken  -  встряхивают
shaking  -  сотрясение
shall  -  должен
shaving  -  бритье
she'd  -  сарай
she's  -  она
sherlock  -  шерлок
shinier  -  блестит
shock  -  шок
shoes  -  обувь
shooter  -  стрелок
shops  -  магазины
shouting  -  крики
showing  -  показ
shown  -  показанный
signal  -  сигнал
signs  -  знаки
sir  -  сэр
sitting  -  сидящий
sittingdown  -  сидя
sizewwwtvsubtitlesnetfont  -  sizewwwtvsubtitlesnetfont
skip  -  пропускать
skull  -  череп
slightly  -  немного
slow  -  медленный
smallish  -  коротковатый
smartphone  -  смартфон
smell  -  запах
smoke  -  дым
smoking  -  курение
sniffer  -  перехватчик
so's  -  так вот
sober  -  трезвый
sociopath  -  социопат
solving  -  решение
soother  -  пустышка
soothers  -  пустышки
sorrywhat  -  Извини, что
sorted  -  отсортированный
sorts  -  виды
sounds  -  звуки
speaking  -  Говорящий
splash  -  всплеск
split  -  Трещина
spoke  -  говорил
sponsor  -  спонсор
spotlight  -  прожектор
spree  -  веселье
spy  -  шпион
squad  -  команда
stamford  -  Stamford
standing  -  постоянный
staring  -  смотреть
starving  -  голодающий
statistically  -  статистически
staying  -  пребывание
stays  -  остается
steady  -  неуклонный
steel  -  стали
stillborn  -  мертворожденный
stopped  -  остановился
stops  -  упоры
straighten  -  выпрямлять
strangers  -  незнакомцы
street's  -  стрит
streets  -  улицы
stress  -  стресс
strictly  -  строго
string  -  строка
stupid  -  глупый
stupidity  -  тупость
subtitles  -  субтитры
sugars  -  сахара
suicide  -  самоубийство
suicides  -  самоубийцы
suitcase  -  чемодан
sum  -  сумма
sunbathing  -  солнечные ванны
suntan  -  загар
suppose  -  предполагать
surprised  -  удивленный
surveillance  -  наблюдение
survivor  -  уцелевший
sustain  -  поддерживать
swallow  -  глотать
taken  -  взятый
talked  -  говорили
talking  -  говорящий
talks  -  переговоры
tan  -  загар
tanned  -  загорелый
taxi  -  такси
taxi's  -  Такси
tea  -  чай
tea'd  -  tea'd
technically  -  технически
teeth  -  зубы
telly  -  телевизор
texted  -  переписывались
texts  -  тексты
that'd  -  что бы
theirreal  -  theirreal
therapist  -  Терапевт
there's  -  есть
they'd  -  они
they'll  -  они будут
they're  -  они
things  -  вещи
thinks  -  думает
thirties  -  тридцатые годы
thoughts  -  мысли
threat  -  угроза
threepatch  -  threepatch
thumb  -  большой палец
tie  -  галстук
till  -  до
times  -  раз
told  -  сказал
took  -  взял
traces  -  следы
traffic  -  трафик
trained  -  обученный
transport  -  транспорт
traumatic  -  травматический
travelled  -  путешествовал
treat  -  рассматривать
treated  -  обрабатывали
tremor  -  тремор
tried  -  пытался
triple  -  тройной
trust  -  доверять
trying  -  пытаясь
turned  -  оказалось
turner  -  токарь
twenty  -  20
umbrella  -  зонтик
unattached  -  непривязанный
uncomfortable  -  неудобный
unlikely  -  вряд ли
unmentioned  -  неупомянутыми
unnoticed  -  незамеченный
unused  -  неиспользуемый
unusual  -  необычный
upgrade  -  Обновить
upset  -  рассториться
upside  -  вверх
upstairs  -  вверх по лестнице
used  -  используемый
username  -  имя пользователя
vacant  -  вакантный
vaporised  -  испаряться
vehicles  -  транспортные средства
vicious  -  порочный
victims  -  жертвы
violence  -  насилие
violent  -  насильственный
violin  -  скрипка
volunteered  -  доброволец
vomit  -  рвотное
waited  -  подождал
waiting  -  ожидание
walked  -  ходил
walking  -  гулять пешком
wall's  -  Уолла
wanted  -  разыскивается
wants  -  хочет
warned  -  предупреждала
was  -  был
wasn't  -  не было
wasted  -  впустую
wasting  -  тратить
watchi  -  watchi
waterloo  -  Ватерлоо
watson  -  уотсон
watsoni  -  watsoni
we'd  -  мы б
we'll  -  Что ж
we're  -  мы
we've  -  мы в
wealthy  -  состоятельный
wearing  -  носить
website  -  Веб-сайт
wedding  -  свадьба
weirder  -  страннее
went  -  отправился
were  -  мы
weren't  -  не было
what's  -  какой
wheeled  -  колесный
where's  -  где
wherever  -  где бы
who'd  -  кто бы
who's  -  кто
wilson  -  Вильсон
wilson's  -  Уилсона
withhold  -  утаивать
won't  -  не будет
wondering  -  интересно
words  -  слова
worked  -  работал
working  -  за работой
worried  -  волновался
worse  -  хуже
worst  -  наихудший
wouldn't  -  не будет
wound  -  рана
wounded  -  раненый
wrists  -  запястьях
written  -  написано
wrote  -  писал
xfont  -  XFont
ya  -  я
years  -  лет
you'd  -  вы бы
you'll  -  Вы будете
you're  -  Вы
you've  -  вы имеете
youi  -  ты я
yours  -  ваш
yup  -  Ага
