'cause  -  потому что
abatement  -  снижение
abigail  -  камеристка
able  -  в состоянии
abortion  -  аборт
about  -  около
acting  -  действующий
actually  -  на самом деле
administration  -  администрация
adventure  -  приключение
after  -  после
again  -  еще раз
againi  -  againi
ages  -  возраст
agesi  -  agesi
agricultural  -  сельскохозяйственное
alice  -  Алиса
alive  -  в живых
all  -  все
allow  -  позволять
allowed  -  позволил
almost  -  почти
alone  -  в одиночестве
already  -  уже
also  -  также
always  -  всегда
am  -  я
amongst  -  среди
and  -  а также
angry  -  сердитый
animal  -  животное
animals  -  животные
announce  -  анонсировать
annual  -  годовой
another  -  другой
answer  -  ответ
answered  -  ответил
anymore  -  больше не
anything  -  что-нибудь
apocalyptic  -  апокалиптический
apparently  -  по всей видимости
applause  -  аплодисменты
approval  -  утверждение
architect  -  архитектор
aren't  -  не
army  -  армия
around  -  вокруг
as  -  в виде
ask  -  просить
asks  -  спрашивает
ass  -  жопа
assi  -  Асси
astral  -  астральный
at  -  в
attach  -  прикреплять
attention  -  внимание
away  -  далеко
awesome  -  здорово
bacchus  -  Вакх
back  -  назад
backi  -  Бачки
bad  -  Плохо
bajanked  -  bajanked
ballot  -  голосование
ballsi  -  ballsi
bambi  -  Бэмби
bar  -  бар
bargain  -  сделка
bargained  -  выторговал
based  -  исходя из
basically  -  в основном
be  -  быть
bear  -  медведь
bearing  -  подшипник
bears  -  медведи
beast  -  зверь
became  -  стал
because  -  потому как
before  -  до
behind  -  за
being  -  являющийся
believe  -  верить
bell  -  колокол
best  -  Лучший
bestiality  -  скотство
bet  -  делать ставку
better  -  лучше
between  -  между
bigger  -  больше
billionyear  -  billionyear
bitchi  -  bitchi
blah  -  вздор
blame  -  вина
blind  -  слепой
boat  -  лодка
boil  -  кипятить
bones  -  скелет
book  -  книга
books  -  книги
boring  -  скучный
borked  -  BORKED
born  -  Родился
boss  -  босс
both  -  и то и другое
boy  -  мальчик
boyfriend  -  дружок
boys  -  мальчиков
brakebills  -  brakebills
branches  -  ветви
brave  -  Храбрый
brief  -  краткое
bring  -  приносить
broached  -  затронута
brothel  -  бордель
brought  -  привел
build  -  строить
built  -  построен
bull  -  бык
bullet  -  пуля
bullshit  -  бред сивой кобылы
bunch  -  гроздь
burn  -  жечь
burning  -  сжигание
but  -  но
by  -  от
bye  -  пока
cabinet  -  кабинет
call  -  вызов
campaign  -  кампания
can  -  Можно
cancer  -  рак
candidatefont  -  candidatefont
cani  -  могу я
case  -  дело
castle  -  замок
castle's  -  Касла
cataloguing  -  каталогизация
catch  -  поймать
catching  -  привлекательный
cause  -  причина
census  -  перепись
century  -  века
certain  -  определенный
champagne  -  шампанское
chance  -  шанс
change  -  изменение
changed  -  изменено
changing  -  изменения
charge  -  заряд
charged  -  заряженный
charti  -  charti
charts  -  графики
chatwins  -  chatwins
cheers  -  ура
childhood  -  детство
children  -  дети
choice  -  выбор
choose  -  выберите
chop  -  нарубить
chose  -  выбрал
citizen  -  гражданин
citizens  -  граждане
citizenship  -  гражданство
civilizing  -  цивилизаторской
claims  -  требования
close  -  Закрыть
coincidence  -  совпадение
cold  -  холодно
coldwater  -  холодная вода
collapsedi  -  collapsedi
collect  -  собирать
colorffffthe  -  colorffffthe
colorffseason  -  colorffseason
come  -  приехать
community  -  сообщество
complete  -  полный
concerned  -  обеспокоенный
concerns  -  проблемы
confusing  -  запутанным
consensual  -  согласованный
consequences  -  последствия
considering  -  принимая во внимание
contents  -  содержание
contract  -  контракт
conversations  -  разговоры
core  -  ядро
corrupt  -  продажный
could  -  мог
course  -  курс
crack  -  трещина
crackling  -  хруст
cranky  -  капризный
creaking  -  скрипучий
creamy  -  сливочный
crown  -  корона
curly  -  кудрявый
cut  -  порез
dadi  -  Дади
dark  -  темно
dating  -  знакомства
day  -  день
deal  -  по рукам
dean  -  декан
death  -  смерть
decisions  -  решения
declare  -  объявлять
dedicate  -  посвятить
defeat  -  поражение
deleted  -  удаленный
deliver  -  доставить
democracy  -  демократия
dependency  -  зависимость
derpsi  -  derpsi
design  -  дизайн
desperation  -  безрассудство
detail  -  подробно
dick  -  Дик
dicks  -  Дикс
dies  -  умирает
different  -  другой
difficult  -  сложно
disappointing  -  разочаровывающий
distance  -  расстояние
diverts  -  режимы переадресации
do  -  делать
doesn't  -  не
dominoes  -  домино
door  -  дверь
dope  -  дурман
down  -  вниз
dragon  -  Дракон
drama  -  драма
dramatic  -  драматичный
drop  -  падение
drunk  -  пьяный
dry  -  сухой
dude  -  чувак
dumb  -  тупой
during  -  в течение
dustier  -  пыльных
dwarf  -  карликовый
dwarves  -  гномы
earth  -  Земля
easy  -  легко
eat  -  есть
economic  -  экономической
egg  -  яйцо
eggs  -  яйца
el  -  эль
election  -  выборы
elections  -  выборы
eliot  -  Элиот
else  -  еще
ember  -  тлеющие угли
emergency  -  крайняя необходимость
emotional  -  эмоциональный
encounters  -  встречи
end  -  конец
energy  -  энергия
enjoy  -  наслаждаться
enough  -  достаточно
entire  -  все
environmental  -  экологическая
episode  -  эпизод
equals  -  равняется
especially  -  особенно
even  -  даже
ever  -  Когда-либо
every  -  каждый
everybody  -  все
everyone  -  все
everything  -  все
exactly  -  в точку
exbest  -  exbest
execute  -  выполнять
exhales  -  выдыхает
explained  -  объяснил
explored  -  исследовал
extinct  -  потухший
eye  -  глаз
eyes  -  глаза
fact  -  факт
failed  -  не смогли
fairies  -  феи
fairiesi  -  fairiesi
fairy  -  фея
fall  -  падать
famine  -  голод
farms  -  фермы
father  -  отец
feasts  -  пиры
fed  -  кормили
feel  -  Чувствовать
feeling  -  чувство
fellow  -  человек
felt  -  почувствовал
feminist  -  феминистка
fen  -  топь
fever  -  лихорадка
fight  -  борьба
figure  -  фигура
figurei  -  figurei
fillorian  -  fillorian
fillorians  -  fillorians
fillory  -  fillory
fillory's  -  fillory-х
filloryi  -  filloryi
finally  -  в конце концов
find  -  найти
finding  -  обнаружение
fine  -  отлично
first  -  первый
firsti  -  сначала я
fishyi  -  fishyi
fit  -  поместиться
fix  -  фиксировать
fixed  -  исправлено
fixing  -  фиксация
flealessness  -  flealessness
floaters  -  поплавки
floodgates  -  шлюзы
flowing  -  текущий
flyers  -  листовок
flying  -  летающий
focus  -  фокус
fogg  -  Фогг
fogg's  -  Фогг-х
follow  -  следовать
food  -  питание
foot  -  фут
for  -  для
force  -  сила
forest  -  лес
former  -  бывший
forth  -  вперед
forward  -  вперед
fountains  -  фонтаны
fourth  -  четвертый
fray  -  изнашиваться
fray's  -  перетирают-х
free  -  свободно
friend  -  друг
from  -  из
fuck  -  Блядь
fucked  -  трахал
fulfilled  -  выполнены
full  -  полный
gain  -  усиление
gaps  -  пробелы
gave  -  дал
gay  -  гей
geraniums  -  герань
get  -  получить
gets  -  получает
gift  -  подарок
giftsi  -  giftsi
give  -  дайте
given  -  данный
giving  -  дающий
glass  -  стакан
go  -  идти
gobbledi  -  gobbledi
goddamn  -  проклятие
godi  -  Годи
gods  -  боги
golden  -  золотой
good  -  хорошо
goose  -  Гусь
government  -  правительство
grad  -  град
grain  -  зерно
granular  -  зернистый
great  -  Великий
greater  -  большая
grocery  -  продуктовый
group  -  группа
grow  -  расти
grown  -  взрослый
growth  -  рост
grumpiness  -  сварливость
guess  -  Угадай
guessing  -  угадывание
gun  -  пистолет
guy  -  парень
hades  -  Аид
half  -  половина
handle  -  ручка
handsi  -  handsi
happen  -  случаться
happenedi  -  happenedi
happily  -  счастливо
happy  -  счастливый
hard  -  жесткий
harpiesi  -  harpiesi
hates  -  ненавидит
have  -  иметь
he  -  он
head  -  глава
headi  -  headi
heal  -  излечивать
healed  -  исцелена
healthcare  -  здравоохранение
healthy  -  здоровый
hearing  -  слух
hedge  -  живая изгородь
hell  -  ад
help  -  Помогите
helpful  -  полезный
her  -  ее
here  -  Вот
hereby  -  настоящим
herpes  -  герпес
hey  -  Привет
hide  -  скрывать
high  -  высокая
highly  -  высоко
him  -  его
his  -  его
hit  -  удар
hog  -  боров
hole's  -  дыры
holy  -  святой
home  -  Главная
hooked  -  зацепили
hooks  -  крючки
hookupmurder  -  hookupmurder
hooray  -  Ура
hope  -  надежда
hopei  -  Хэбэй
hordes  -  полчища
horrifying  -  ужасающий
hour  -  час
house  -  дом
how  -  как
how's  -  как это
human  -  человек
humans  -  люди
humbledrum  -  humbledrum
hundred  -  сто
hurl  -  метать
hurt  -  причинить боль
ia  -  Айова
iall  -  Я все
iand  -  я и
iare  -  iare
ibecause  -  ibecause
ibut  -  но я
idea  -  идея
idespite  -  idespite
idiots  -  идиоты
idri  -  IDRI
ieat  -  я ем
ielection  -  ielection
ieveryone  -  ieveryone
iextending  -  iextending
if  -  если
ifor  -  я для
ignorant  -  невежественный
ignore  -  игнорировать
ii  -  б
iii  -  III
iinvaded  -  iinvaded
iit's  -  ИИТ
ijulia  -  ijulia
ikady  -  ikady
ilooks  -  ilooks
ilovesi  -  ilovesi
ilowinterest  -  ilowinterest
imagine  -  представить
imeanwhile  -  imeanwhile
implanted  -  имплантированный
impossible  -  невозможно
imy  -  IMY
in  -  в
indeed  -  в самом деле
individuals  -  индивидуумы
information  -  Информация
infrastructurei  -  infrastructurei
inhales  -  вдыхает
injured  -  пострадавший
innards  -  внутренности
ino  -  я не
inside  -  внутри
inspiring  -  вдохновляющий
instagram  -  Instagram
intend  -  намереваться
intended  -  предназначена
intentionally  -  намеренно
interest  -  интерес
interesting  -  интересно
intermarry  -  породниться
interrupting  -  прерывающий
into  -  в
invited  -  приглашенный
iotheri  -  iotheri
ipreviously  -  ipreviously
iregulation  -  iregulation
iso  -  ISO
istep  -  Истэп
it  -  Это
it'd  -  это было
ithanks  -  ithanks
ithat  -  ithat
ithat's  -  ithat-х
iti  -  ити
ito  -  ито
its  -  его
iuntil  -  iuntil
iwe  -  IWE
iwell  -  Я хорошо
iwere  -  я был
iwhere  -  iwhere
iwith  -  я с
iyou  -  я тебя
jacked  -  измученный
jersey  -  Джерси
job  -  работа
josh  -  мистифицировать
judging  -  судейство
judgment  -  суждение
julia  -  Юлия
julia's  -  Джулии
just  -  просто
kady  -  Кади
kadyi  -  kadyi
keep  -  держать
kept  -  хранится
kettle  -  чайник
key  -  ключ
keyi  -  кэе
keys  -  ключи
kill  -  убийство
killers  -  убийцы
kind  -  своего рода
kinda  -  вроде
king  -  король
kings  -  короли
kinko's  -  Кинко
kinky  -  курчавый
know  -  знать
known  -  известен
knowsi  -  knowsi
lady  -  леди
lair  -  логово
last  -  последний
late  -  поздно
later  -  позже
laughing  -  смеющийся
laughs  -  смеется
law  -  закон
leaked  -  утечка
learn  -  учить
least  -  наименее
leave  -  оставлять
leaving  -  уход
left  -  оставил
leftover  -  пережиток
less  -  Меньше
let  -  позволять
liar  -  лжец
librarian  -  библиотекарь
libraryi  -  libraryi
lice  -  вши
life  -  жизнь
lifei  -  Lifei
lifespans  -  продолжительность жизни
like  -  как
likely  -  вероятно
limp  -  прихрамывать
listed  -  перечисленных
listen  -  Слушать
lit  -  освещенный
literally  -  буквально
little  -  немного
littlei  -  littlei
lived  -  жил
lives  -  жизни
living  -  живой
loans  -  кредитование
locate  -  разместить
locater  -  Locater
long  -  длинный
look  -  смотреть
lorians  -  lorians
lot  -  много
love  -  люблю
loved  -  любимый
lover  -  любовник
lowest  -  низший
loyalty  -  лояльность
magic  -  магия
magic's  -  Волшебства
magically  -  волшебно
magici  -  magici
magician  -  волшебник
magiciansfont  -  magiciansfont
make  -  делать
makes  -  марки
malodorous  -  зловонный
many  -  многие
margo  -  Margo
mark  -  отметка
married  -  в браке
matter  -  дело
matteri  -  matteri
may  -  май
maybe  -  может быть
me  -  меня
mean  -  имею в виду
means  -  означает
meanwhile  -  между тем
meeting  -  встреча
member  -  член
memory  -  Память
met  -  встретил
metal  -  металл
might  -  мог бы
million  -  миллиона
mind  -  разум
minei  -  Минеи
minute  -  минут
miss  -  Мисс
mistakes  -  ошибки
moist  -  влажный
moment  -  момент
monster  -  монстр
montage  -  монтаж
months  -  месяцы
mood  -  настроение
more  -  Больше
morning  -  утро
mortals  -  смертные
most  -  большинство
mother  -  мама
motive  -  мотив
mouth  -  рот
moved  -  переехал
much  -  много
muffled  -  заглушенный
murder  -  убийство
music  -  Музыка
must  -  должен
my  -  мой
myself  -  себя
mysterious  -  загадочный
mysteriously  -  таинственно
name  -  имя
native  -  родной
nearby  -  рядом, поблизости
need  -  необходимость
needed  -  необходимый
needs  -  потребности
negotiate  -  вести переговоры
never  -  никогда
new  -  новый
news  -  Новости
newsi  -  newsi
next  -  следующий
nice  -  хороший
niffin  -  niffin
night  -  ночь
nipples  -  соски
no  -  нет
nobody  -  никто
nointerest  -  нет интереса
none  -  никто
northern  -  северный
not  -  не
nothing  -  ничего
now  -  Теперь
obamacare  -  Obamacare
obnoxious  -  противный
of  -  из
off  -  от
offense  -  преступление
offer  -  предлагает
official  -  официальный
ofi  -  офи
oh  -  ой
okay  -  Хорошо
old  -  старый
olu  -  Олу
on  -  на
once  -  один раз
one  -  один
oni  -  ДВР
only  -  только
open  -  открытый
opened  -  открытый
opening  -  открытие
or  -  или
orchard  -  фруктовый сад
orloffdiaz  -  orloffdiaz
other  -  Другие
otherwise  -  в противном случае
our  -  наш
ouroboros  -  уроборос
out  -  вне
outlaw  -  вне закона
over  -  над
owe  -  задолжать
own  -  своя
part  -  часть
parties  -  стороны
parts  -  части
party  -  вечеринка
pass  -  проходить
pathetic  -  жалкий
patriarchal  -  патриархальный
patronizing  -  покровительствующий
peace  -  мир
peasants  -  крестьяне
penny  -  пенни
penny's  -  пенни
people  -  люди
perfectly  -  в совершенстве
perhaps  -  возможно
permission  -  разрешение
person  -  человек
perspective  -  перспективы
pickwick  -  Пиквик
pigeon  -  голубь
pity  -  жалость
place  -  место
plain  -  гладкий
plan  -  план
plane  -  самолет
planted  -  посаженный
plants  -  растения
please  -  пожалуйста
pluck  -  срывать
plus  -  плюс
point  -  точка
pokes  -  тыкает
policies  -  полисы
policy  -  политика
polite  -  вежливый
politics  -  политика
polls  -  опросы
porked  -  porked
portal  -  портал
possibly  -  возможно
post  -  после
posteri  -  posteri
postsi  -  postsi
poverty  -  бедность
power  -  мощность
powered  -  питание
powerful  -  мощный
powerless  -  бессильный
pray  -  молиться
prayers  -  молитвы
praying  -  молиться
predict  -  прогнозировать
pretty  -  Симпатичная
prevent  -  не допустить
prison  -  тюрьма
prob  -  проб
probably  -  вероятно
problem  -  проблема
project  -  проект
promise  -  обещание
promised  -  обещанный
proposition  -  предложение
protection  -  защита
proved  -  доказано
psyched  -  свихнувшийся
punished  -  наказали
purpose  -  цель
pursuit  -  преследование
put  -  положил
putting  -  сдачи
queen  -  Королева
queen's  -  ферзевый
queensi  -  queensi
quentin  -  Квентин
quest  -  поиск
questers  -  начать поиски
questi  -  questi
questing  -  квестинг
question  -  вопрос
quiet  -  тихо
quite  -  довольно
rabbit  -  кролик
rafe  -  Рейф
rampant  -  безудержный
ran  -  побежал
rapist  -  насильник
ratings  -  рейтинги
ray  -  луч
reading  -  чтение
ready  -  готов
real  -  реальный
really  -  действительно
realm  -  область
reason  -  причина
recap  -  резюмировать
receive  -  Получать
recently  -  в последнее время
recognize  -  признать
referi  -  referi
reign  -  царствовать
reliable  -  надежный
remember  -  запомнить
reminded  -  напомнил
remission  -  ремиссия
rentali  -  rentali
replace  -  замещать
replaced  -  заменены
reproduce  -  воспроизводить
requires  -  требует
research  -  исследование
respected  -  уважаемый
response  -  ответ
restore  -  восстановить
results  -  Результаты
reunified  -  воссоединиться
revolted  -  восстали
revolutionary  -  революционер
reynard  -  Рейнеке-лис
riddle  -  загадка
right  -  правильно
rigorous  -  тщательный
ringing  -  звонкий
ripping  -  потрясающий
risks  -  риски
rot  -  гниль
roxanne  -  Роксана
ruined  -  разрушенный
rule  -  правило
running  -  Бег
runoffi  -  runoffi
russian  -  русский
sacks  -  мешочки
sacrifice  -  жертва
sacrificed  -  принесена в жертву
sacrifices  -  жертвы
safeguard  -  защита
sake  -  ради
same  -  одна и та же
sat  -  сидел
save  -  спасти
saved  -  сохранены
say  -  сказать
saying  -  поговорка
school  -  школа
search  -  поиск
seat  -  сиденье
second  -  второй
secret  -  секрет
sectors  -  секторов
security  -  безопасность
see  -  видеть
seem  -  казаться
send  -  Отправить
sense  -  смысл
sent  -  послал
service  -  оказание услуг
set  -  задавать
settle  -  селиться
seven  -  семь
shall  -  должен
shared  -  общий
she  -  она
she'd  -  сарай
she'si  -  she'si
ship  -  корабль
shit  -  дерьмо
shithole  -  дыра
shocker  -  бульварный роман
shoot  -  стрелять
shopping  -  поход по магазинам
should  -  должен
shouldn't  -  не должен
show  -  показать
showed  -  показал
showering  -  литься
shrills  -  shrills
shut  -  закрыть
sight  -  взгляд
signed  -  подписанный
simply  -  просто
sing  -  петь
siphon  -  сифон
sixth  -  шестой
skipped  -  пропущено
sky  -  небо
slaveryi  -  slaveryi
slipped  -  проскользнул
sloth  -  леность
smart  -  умная
smartest  -  смышленым
snagged  -  зацепил
sniffling  -  сопение
snort  -  фырканье
so  -  так
sober  -  трезвый
societal  -  социальный
soft  -  мягкий
solidest  -  solidest
somber  -  угрюмый
some  -  некоторые
somebody  -  кто-то
someone  -  кто то
something  -  что нибудь
somewhere  -  где-то
son  -  сын
sorry  -  Прости
sort  -  Сортировать
sorts  -  виды
source  -  источник
spark  -  искра
speak  -  говорить
special  -  особый
spell  -  орфографии
spied  -  подсмотрел
spiritual  -  духовный
spot  -  место
stability  -  стабильность
stammers  -  заикается
stand  -  стоять
standard  -  стандарт
standstill  -  остановка
start  -  Начало
starving  -  голодающий
staticky  -  staticky
stay  -  оставаться
stayed  -  остались
stepfather  -  отчим
stepsisters  -  сводные сестры
still  -  все еще
stone  -  камень
stop  -  стоп
stopped  -  остановился
storm  -  буря
story  -  история
straight  -  Прямо
stranger  -  незнакомец
strategy  -  стратегия
straw  -  солома
struggle  -  борьба
stuck  -  застрял
studentsi  -  studentsi
stuff  -  материал
subjects  -  предметы
suggests  -  предполагает
summeri  -  summeri
supplies  -  предметы снабжения
support  -  поддержка
supposed  -  предполагаемый
sure  -  конечно
surrendering  -  капитуляция
survey  -  опрос
survive  -  уцелеть
suspenseful  -  напряженное ожидание
swear  -  клянусь
syracuse  -  Сиракузы
taboo  -  табу
taco  -  тако
take  -  принимать
talk  -  говорить
tattoos  -  татуировки
tea  -  чай
teach  -  учат
tell  -  рассказать
ten  -  10
tense  -  напряженный
term  -  срок
terms  -  сроки
terrified  -  ужас
test  -  контрольная работа
than  -  чем
thank  -  спасибо
thanks  -  благодаря
that  -  что
that's  -  это
the  -  the
their  -  их
them  -  их
then  -  тогда
there  -  там
these  -  эти
they  -  Oни
they'll  -  они будут
thigh  -  бедренная кость
thing  -  вещь
think  -  думать
thinking  -  мышление
thinks  -  думает
this  -  это
thisi  -  Thisi
those  -  те
thought  -  думал
thousand  -  тысяча
thousands  -  тысячи
threatened  -  под угрозой
three  -  три
threesome  -  тройка
throne  -  трон
thrones  -  троны
through  -  через
tick  -  поставить галочку
tick's  -  клеща
time  -  время
timeline  -  график
tiny  -  крошечный
title  -  заглавие
to  -  в
toes  -  пальцы
too  -  слишком
top  -  Вверх
tormenting  -  мучительный
total  -  Всего
totally  -  полностью
touch  -  потрогать
touching  -  трогательный
track  -  трек
trail  -  след
tree  -  дерево
trees  -  деревья
trial  -  испытание
trick  -  трюк
trickster  -  обманщик
trouble  -  беда
true  -  правда
truei  -  truei
truth  -  правда
truthfully  -  правдиво
try  -  пытаться
tuesdays  -  по вторникам
turn  -  очередь
turned  -  оказалось
two  -  два
umber  -  умбра
under  -  под
underground  -  метро
understand  -  Понимаю
understanding  -  понимание
underworld  -  подземный мир
underworldi  -  underworldi
unfuck  -  unfuck
uninspiring  -  скучны
unity  -  единство
unless  -  если
unlock  -  отпереть
until  -  до
up  -  вверх
upwards  -  вверх
us  -  нас
use  -  использование
vague  -  расплывчатый
very  -  очень
village  -  деревня
villages  -  деревни
violations  -  нарушения
voices  -  голоса
vote  -  голос
wa  -  Вашингтон
wage  -  заработная плата
wait  -  Подождите
walk  -  ходить
walkietalkie  -  рация
walking  -  гулять пешком
want  -  хотеть
wants  -  хочет
warm  -  тепло
wastei  -  wastei
waterfall  -  водопад
way  -  путь
ways  -  пути
we  -  мы
we'd  -  мы б
we'll  -  Что ж
wealth  -  богатство
week  -  неделю
weird  -  странный
well  -  Что ж
wellresearched  -  wellresearched
went  -  отправился
western  -  вестерн
what  -  какие
whatever  -  без разницы
when  -  когда
where  -  где
which  -  который
whiningwhirring  -  whiningwhirring
whitespire  -  whitespire
who  -  кто
whoever  -  кто бы ни
whole  -  все
whom  -  кого
why  -  Зачем
wicker  -  плетеный
wild  -  дикий
will  -  будем
willi  -  Willi
willing  -  готовы
win  -  выиграть
window  -  окно
wisely  -  мудро
wish  -  желание
witches  -  ведьмы
with  -  с
withholding  -  удержание
without  -  без
women  -  женщины
won  -  выиграл
wonk  -  зубрила
work  -  Работа
worked  -  работал
world  -  Мир
worried  -  волновался
worse  -  хуже
worth  -  стоимость
would  -  бы
write  -  записывать
wrong  -  неправильно
wrote  -  писал
yeah  -  Да
yeahi  -  да я
year  -  год
yes  -  да
yet  -  все же
you  -  вы
youi  -  ты я
your  -  ваш
yourself  -  сам
