'cause  -  потому что
'em  -  'Эм
'round  -  'круглый
aah  -  ааа
aand  -  а и
abandoned  -  заброшенный
abducted  -  похищена
ability  -  способность
able  -  в состоянии
about  -  около
aboutface  -  aboutface
above  -  выше
absolutely  -  абсолютно
accepted  -  принято
access  -  доступ
accident  -  авария
accidentally  -  случайно
accompany  -  сопровождать
accomplish  -  выполнять
accomplished  -  осуществляется
across  -  через
act  -  акт
acting  -  действующий
actions  -  действия
activity  -  Мероприятия
actual  -  фактический
actually  -  на самом деле
adjectives  -  прилагательные
admire  -  восхищаться
admit  -  признавать
adult  -  для взрослых
advisor  -  консультант
afraid  -  боюсь
after  -  после
again  -  еще раз
againi  -  againi
against  -  против
aged  -  престарелый
agenda  -  повестка дня
ages  -  возраст
ago  -  тому назад
agree  -  дать согласие
ah  -  ах
ahead  -  впереди
ahh  -  ааа
ain't  -  не
air  -  воздух
albums  -  альбомы
aliens  -  инопланетяне
alive  -  в живых
all  -  все
all's  -  все в
allow  -  позволять
allowed  -  позволил
alltimei  -  alltimei
almost  -  почти
alone  -  в одиночестве
along  -  вдоль
already  -  уже
also  -  также
alternate  -  чередовать
always  -  всегда
alzyheimer  -  alzyheimer
am  -  я
amazing  -  удивительно
ambulance  -  скорая помощь
american  -  американский
americans  -  американцов
amish  -  амишей
amount  -  количество
amphetamine  -  амфетамин
amusement  -  развлечение
an  -  an
ancestors  -  предки
and  -  а также
angry  -  сердитый
animal  -  животное
anne  -  анна
annoying  -  раздражающий
another  -  другой
answer  -  ответ
answering  -  автоответчик
antique  -  античный
any  -  Любые
anybody  -  кто-нибудь
anybody's  -  кто это
anymore  -  больше не
anyone  -  кто угодно
anyone's  -  кто это
anything  -  что-нибудь
anytime  -  в любой момент
anyway  -  так или иначе
anywhere  -  в любом месте
apart  -  Кроме
apologize  -  принести извинения
apologized  -  извинился
apologizing  -  извиняясь
apparently  -  по всей видимости
appear  -  появиться
appreciate  -  ценить
approve  -  одобрить
archives  -  архив
are  -  находятся
aren't  -  не
arghh  -  arghh
argumentative  -  аргументированный
ariveses  -  ariveses
around  -  вокруг
arrested  -  арестованный
as  -  в виде
ashes  -  пепел
aside  -  в стороне
ask  -  просить
asked  -  спросил
asking  -  просить
asks  -  спрашивает
ass  -  жопа
assassination  -  убийство
asshat  -  asshat
at  -  в
at's  -  в годах
athletic  -  Спортивное
atlanta  -  атланта
atnow  -  сейчас
attack  -  атака
attacked  -  атакован
attacks  -  нападки
attempt  -  попытка
attention  -  внимание
auction  -  аукцион
audience  -  аудитория
aunt  -  тетка
authority  -  власть
avid  -  алчный
avoided  -  избегать
aw  -  ав
awake  -  бодрствующий
aware  -  знать
away  -  далеко
awful  -  ужасный
awfully  -  ужасно
awkward  -  неловко
awry  -  косо
babies  -  дети
babysitting  -  няня
back  -  назад
backseat  -  заднее сиденье
bad  -  Плохо
badge  -  значок
badly  -  плохо
bag  -  мешок
bailed  -  взятый на поруки
ball  -  мяч
band  -  группа
banter  -  подшучивать
barely  -  едва
barging  -  баржами
basement  -  подвал
batch  -  партия
bathroom  -  ванная
battle  -  боевой
be  -  быть
beach  -  пляж
beast  -  зверь
beating  -  битье
beautiful  -  красивая
beauty  -  красота
bebclose  -  bebclose
because  -  потому как
become  -  стали
becomes  -  становится
becoming  -  становление
bed  -  постель
bedroom  -  Спальня
been  -  было
beer  -  пиво
before  -  до
beg  -  очень прошу
beginning  -  начало
begins  -  начинается
behavior  -  поведение
behind  -  за
being  -  являющийся
belief  -  вера
believable  -  правдоподобно
believe  -  верить
believed  -  Считается,
believer  -  верующий
believing  -  полагая
bell  -  колокол
bella  -  Белла
belong  -  принадлежать
bench  -  скамейка
benjamin  -  Бенджамен
bennett  -  беннетт
berlin  -  Берлин
besides  -  Кроме
best  -  Лучший
bet  -  делать ставку
beth's  -  Беф-х
better  -  лучше
between  -  между
beyond  -  за
big  -  большой
bigger  -  больше
biggest  -  самый большой
bikini  -  бикини
bikinis  -  бикини
bill  -  законопроект
bin  -  бункер
bird  -  птица
birdhouse  -  скворечник
birthday  -  день рождения
bit  -  немного
bitch  -  сука
bite  -  укусить
bites  -  укусы
biting  -  едкий
bitten  -  укушенный
blacked  -  затемненными
blah  -  вздор
blank  -  пустой
bleeding  -  кровотечение
blinds  -  шторы
blockage  -  блокировка
blood  -  кровь
bloops  -  завывания
blows  -  ударов
blue  -  синий
blunt  -  тупой
board  -  доска
boarding  -  посадка
boardinghouse  -  пансион
bodies  -  тела
body  -  тело
bones  -  скелет
bonnie  -  Bonnie
bonnie's  -  Бонни
book  -  книга
books  -  книги
boozy  -  поддатый
bore  -  расточка
bored  -  скучающий
boring  -  скучный
born  -  Родился
borrow  -  заимствовать
both  -  и то и другое
bothered  -  беспокоили
bothering  -  утруждая
bottle  -  бутылка
bowl  -  миска
box  -  коробка
boy  -  мальчик
boyfriend  -  дружок
boys  -  мальчиков
brady  -  Brady
brag  -  хвастать
bread  -  хлеб
break  -  ломать
breaking  -  ломка
breaks  -  брейки
breath  -  дыхание
breathe  -  дышать
breathing  -  дыхание
brick  -  кирпич
bridge  -  мост
brightest  -  яркий
bring  -  приносить
bringing  -  приведение
brings  -  приносит
broke  -  сломал
bronte  -  Бронте
brother  -  брат
brother's  -  брат
brothers  -  братья
brought  -  привел
brown  -  коричневый
bruises  -  ушибы
brush  -  щетка
brutal  -  зверский
btw  -  кстати
bucket  -  ведро
buddy  -  дружище
buffet  -  буфет
bufrom  -  bufrom
bugging  -  тайное наблюдение с помощью малогабаритных электронных средств
building  -  здание
buildings  -  здания
built  -  построен
bullets  -  пули
bully  -  задира
bunch  -  гроздь
bunnies  -  кролики
burden  -  бремя
buried  -  похороненный
burn  -  жечь
burned  -  сожженный
business  -  бизнес
busy  -  занятый
but  -  но
buy  -  купить
buzz  -  жужжание
by  -  от
bye  -  пока
calculating  -  расчета
call  -  вызов
called  -  называется
calling  -  призвание
came  -  пришел
camp  -  лагерь
campers  -  кемперы
can  -  Можно
can't  -  не может
cancelled  -  отменен
candle  -  свеча
candles  -  свечи
cannot  -  не могу
canvassed  -  обсужденный
captured  -  захваченный
car  -  автомобиль
car's  -  легковые автомобили
card  -  карта
care  -  забота
cared  -  уход
career  -  карьера
careful  -  осторожный
careless  -  неосторожный
caring  -  заботливая
carnage  -  резня
caroline  -  Каролина
caroline's  -  Кэролайн
carolinewhat  -  carolinewhat
carried  -  осуществляется
cars  -  легковые автомобили
carson  -  Carson
case  -  дело
casings  -  оболочки
casualties  -  жертвы
catch  -  поймать
catherine  -  Екатерина
caught  -  пойманный
cause  -  причина
caverns  -  каверны
caws  -  каркает
cecemery  -  cecemery
ceiling  -  потолок
celebrate  -  праздновать
celebration  -  праздник
cell  -  клетка
cellphone  -  Сотовый телефон
cellphones  -  сотовые телефоны
celtic  -  кельтская
cemetery  -  кладбище
central  -  центральный
centuries  -  века
century  -  века
ceramic  -  керамический
certain  -  определенный
certainly  -  безусловно
chain  -  цепь
challenging  -  испытывающий
chamallow  -  chamallow
chance  -  шанс
change  -  изменение
changed  -  изменено
changes  -  изменения
charge  -  заряд
charity  -  благотворительная деятельность
charles  -  Чарльз
charm  -  очарование
chase  -  гнаться
chased  -  преследовали
chatter  -  болтовня
chatting  -  в чате
cheating  -  мошенничество
check  -  проверить
checked  -  проверено
cheek  -  щека
cheerleader  -  болельщик
cheerleading  -  черлидинг
cheese  -  сыр
chick  -  цыпленок
chicken  -  курица
chicks  -  птенцы
childhood  -  детство
chill  -  простуда
chitchat  -  болтовня
choice  -  выбор
choices  -  выбор
choose  -  выберите
chose  -  выбрал
chuckle  -  посмеиваться
chuckles  -  посмеивается
chuckling  -  посмеиваясь
church  -  церковь
circulation  -  циркуляция
citizens  -  граждане
civil  -  гражданского
civilian  -  гражданский
civilians  -  гражданское население
claimed  -  утверждал
claims  -  требования
clairvoyant  -  ясновидящий
class  -  класс
classes  -  классы
classy  -  классный
clean  -  чистый
clear  -  Чисто
clearly  -  явно
clicking  -  щелкающий
clicks  -  щелчки
close  -  Закрыть
closer  -  ближе
closes  -  закрывается
closest  -  ближайший
clown  -  клоун
clumsy  -  топорный
coach  -  тренер
cocky  -  самоуверенный
cod  -  треска
coffee  -  кофе
coin  -  монета
cold  -  холодно
collection  -  коллекция
color  -  цвет
colorffff  -  colorffff
column  -  колонка
come  -  приехать
comes  -  выходит
comet  -  комета
comet's  -  кометы
coming  -  приход
comment  -  комментарий
commenting  -  комментирование
commercial  -  коммерческая
commercial's  -  рекламные ролики
commitment  -  обязательство
committed  -  привержен
compared  -  в сравнении
compelled  -  вынужденный
competition  -  соревнование
complete  -  полный
completed  -  завершено
completely  -  полностью
complicated  -  сложно
compulsion  -  принуждение
concentrate  -  концентрат
concern  -  беспокойство
concerned  -  обеспокоенный
condition  -  состояние
confederacy  -  конфедерация
confederate  -  конфедерат
conference  -  конференция
confirm  -  подтвердить
confused  -  смущенный
conjure  -  заклинать
constant  -  постоянная
contact  -  контакт
contains  -  содержит
contemplate  -  созерцать
control  -  контроль
conversation  -  разговор
convinced  -  убежденный
cook  -  готовить
cool  -  круто
coping  -  справляясь
cops  -  менты
corner  -  угол
corpse  -  труп
correct  -  верный
corrected  -  исправленный
correctly  -  правильно
couch  -  диван
coughing  -  кашляющий
coughs  -  кашляет
could  -  мог
couldn't  -  не может
council  -  совет
count  -  подсчитывать
counting  -  подсчет
country  -  страна
couple  -  пара
course  -  курс
cover  -  обложка
cracked  -  треснувший
crackheads  -  crackheads
craftier  -  хитрее
crap  -  дерьмо
crashing  -  грохот
crave  -  жаждать
craving  -  страстное желание
crazy  -  псих
creak  -  скрип
create  -  Создайте
created  -  созданный
creative  -  творческий
creatures  -  существа
creek  -  ручей
creepy  -  жутко
crest  -  гребень
crippled  -  калека
crossword  -  кроссворд
crow  -  ворона
crow's  -  вороний
crown  -  корона
crucifixes  -  распятий
crushing  -  дробление
cry  -  плакать
crypt  -  крипта
crystal  -  кристалл
culprit  -  преступник
cup  -  кружка
cursed  -  проклят
curtain  -  занавес
cut  -  порез
cute  -  милый
d't  -  d'т
da  -  да
dad  -  папа
dad's  -  папа
daly  -  Daly
damaged  -  поврежденный
damien  -  Дэмиен
damn  -  черт
damon  -  Дэймон
damon's  -  Дэймон
dance  -  танец
danced  -  танцевал
dancing  -  танцы
danger  -  Опасность
dangerous  -  опасно
dark  -  темно
darren  -  Даррен
database  -  база данных
date  -  Дата
dated  -  датированный
dates  -  даты
dating  -  знакомства
day  -  день
day's  -  Дэй
days  -  дней
dead  -  мертвый
deadly  -  смертоносный
deal  -  по рукам
dealing  -  дело
dear  -  Уважаемые
death  -  смерть
deceased  -  умерший
december  -  Декабрь
decide  -  принимать решение
decided  -  приняли решение
decides  -  решает
decorative  -  декоративный
deduced  -  счислимый
deep  -  глубоко
deeper  -  Глубже
deeprooted  -  deeprooted
defending  -  защиты
defies  -  бросает вызов
definition  -  определение
deflowered  -  девственности
delicate  -  нежный
delinquent  -  правонарушитель
demand  -  спрос
demon  -  демон
denial  -  отказ
dental  -  зубоврачебный
deny  -  Отрицать
department  -  отдел
depends  -  зависит
deposit  -  депозит
deserved  -  заслуженный
desiccate  -  высушивать
dessert  -  Десерт
destroy  -  уничтожить
destroyed  -  разрушенный
dial  -  набирать номер
diaries  -  дневников
diariesi  -  diariesi
diary  -  дневник
dick  -  Дик
did  -  сделал
didn't  -  не
didn'tread  -  didn'tread
die  -  умереть
died  -  умер
diet  -  диета
difference  -  разница
different  -  другой
differs  -  отличается
digitized  -  оцифрованы
dinner  -  ужин
disagree  -  не соглашаться
disappearing  -  исчезающий
discounts  -  скидки
discover  -  обнаружить
discovered  -  обнаруженный
discussion  -  обсуждение
dishes  -  блюда
dispatch  -  отправка
display  -  дисплей
distant  -  отдаленный
distraction  -  отвлечение
ditching  -  рытье канав
divided  -  разделенный
divorced  -  разведенный
do  -  делать
doc  -  доктор
doc'll  -  doc'll
doctor  -  врач
does  -  делает
doesn't  -  не
doin'  -  делает
doing  -  дела
don't  -  не
don'tell  -  don'tell
done  -  сделанный
donn't  -  donn't
donovan  -  Донован
doom  -  гибель
doomed  -  обреченный
door  -  дверь
doorbell  -  дверной звонок
dot  -  точка
double  -  двойной
doubled  -  двойной
doubt  -  сомнение
douche  -  душ
down  -  вниз
drained  -  осушенных
drama  -  драма
drank  -  пил
draw  -  привлечь
drawer  -  выдвижной ящик
drawn  -  вничью
dreaded  -  ужасный
dream  -  мечта
dreamed  -  снилось
dress  -  платье
drift  -  дрейф
drink  -  напиток
drinkable  -  годный для питья
drinking  -  питьевой
drinks  -  напитки
drip  -  капельный
drive  -  водить машину
driven  -  управляемый
driver  -  Водитель
drives  -  диски
drop  -  падение
dropped  -  упал
drove  -  поехали
drug  -  лекарственное средство
druggies  -  наркоманы
drugs  -  наркотики
drugusing  -  drugusing
druids  -  друиды
drunk  -  пьяный
dry  -  сухой
dude  -  чувак
due  -  в связи
duh  -  Дух
duly  -  должным образом
dumb  -  тупой
dumbed  -  упрощенных
dump  -  свалка
dumped  -  сбрасывали
dumping  -  демпинг
during  -  в течение
dusk  -  смеркаться
duty  -  обязанность
dylan  -  Дилан
dysfunctional  -  дисфункциональный
each  -  каждый
earlier  -  ранее
early  -  рано
earned  -  заработанный
ears  -  уши
easy  -  легко
eat  -  есть
eating  -  принимать пищу
ebay  -  Ebay
edward's  -  Эдвард
eeverything  -  eeverything
effort  -  усилие
either  -  или
elena  -  елена
elena's  -  Елены
ellis  -  Эллис
else  -  еще
email  -  Эл. адрес
embedded  -  встроенный
emerson  -  Эмерсон
emotional  -  эмоциональный
end  -  конец
ended  -  закончился
energy  -  энергия
engage  -  заниматься
english  -  английский
enjoy  -  наслаждаться
enjoys  -  пользуется
enlighten  -  просветить
enough  -  достаточно
enter  -  войти
entertained  -  развлекаться
entire  -  все
entitled  -  озаглавленный
entrance  -  вход
epic  -  эпический
episode  -  эпизод
escape  -  побег
escort  -  эскорт
escorted  -  сопровождают
especially  -  особенно
estate  -  имущество
eternal  -  вечный
eternity  -  вечность
even  -  даже
evening  -  вечер
event  -  мероприятие
events  -  Мероприятия
eventually  -  в итоге
ever  -  Когда-либо
every  -  каждый
everybody  -  все
everyone  -  все
everyone's  -  все это
everything  -  все
everything's  -  все в
everywhere  -  везде
eviden  -  Доказательство том
evil  -  зло
ex  -  бывший
exactly  -  в точку
example  -  пример
examples  -  Примеры
excellent  -  отлично
except  -  Кроме
exchanged  -  обмен
excuse  -  оправдание
excuses  -  предлоги
exes  -  EXEs
exgirlfriend  -  бывшая девушка
exhales  -  выдыхает
exist  -  существовать
expanding  -  расширяющийся
expect  -  ожидать
expend  -  израсходовать
explain  -  объяснять
explained  -  объяснил
expose  -  разоблачать
expressing  -  выражающий
extended  -  расширенный
extra  -  дополнительный
extremely  -  очень
eye  -  глаз
eyes  -  глаза
fabulous  -  невероятный
face  -  лицо
fact  -  факт
facts  -  факты
fade  -  увядать
fads  -  коньки
fail  -  потерпеть неудачу
fairly  -  довольно
fall  -  падать
falls  -  падения
familiar  -  знакомые
families  -  семьи
family  -  семья
family's  -  семьи
fan  -  поклонник
far  -  далеко
fast  -  быстро
faster  -  Быстрее
fatalist  -  фаталист
father  -  отец
fault  -  придираться
favor  -  благоприятствовать
favorite  -  любимый
favorites  -  избранное
fear  -  страх
fed  -  кормили
fedex  -  FedEx
feed  -  корм
feeding  -  кормление
feel  -  Чувствовать
feeling  -  чувство
feels  -  чувствует
feely  -  Фили
feigned  -  притворный
feisty  -  энергичный
fell  -  упал
female  -  женский пол
fessed  -  призналась
few  -  мало
fiction  -  фантастика
field  -  поле
fifties  -  пятидесятые годы
fight  -  борьба
fighting  -  борьба
figure  -  фигура
figures  -  цифры
filled  -  заполненный
final  -  окончательный
finally  -  в конце концов
find  -  найти
finds  -  находки
fine  -  отлично
finish  -  Конец
finishing  -  отделка
fire  -  Огонь
fired  -  уволен
first  -  первый
firstborn  -  первенец
fitting  -  примерка
fitzgerald  -  Fitzgerald
fix  -  фиксировать
flames  -  огонь
fled  -  бежал
flies  -  летит
florida  -  Флорида
flower  -  цветок
flustered  -  возбужденный
fly  -  летать
focus  -  фокус
fog  -  туман
foggy  -  туманный
follow  -  следовать
following  -  следующий
font  -  шрифт
food  -  питание
fooling  -  дезориентация
foot  -  фут
footage  -  метраж
football  -  футбол
football's  -  футбола
for  -  для
forbes  -  Форбса
force  -  сила
forced  -  принудительный
forcing  -  форсирование
foremost  -  в первую очередь
forensic  -  судебный
forever  -  навсегда
forfeit  -  утрачивать
forget  -  забывать
forgive  -  прощать
forgood  -  для блага
forgot  -  забыл
form  -  форма
forward  -  вперед
found  -  найденный
founder's  -  учредительский
founders  -  учредители
founding  -  учредительный
fourth  -  четвертый
freak  -  урод
freaked  -  испещренный
freakin'  -  Freakin'
freaking  -  долбанные
freaky  -  бредовый
free  -  свободно
freebies  -  халява
freed  -  освобожденный
french  -  Французский
fresh  -  свежий
freshman  -  первокурсник
friend  -  друг
friend's  -  друзья,
friends  -  друзья
fries  -  картофель фри
from  -  из
front  -  фронт
full  -  полный
fullblown  -  fullblown
fun  -  весело
fund  -  фонд
funeral  -  похороны
funny  -  веселая
future  -  будущее
fyi  -  FYI
gal  -  гал
game  -  игра
games  -  игры
garlic  -  чеснок
gasping  -  затрудненное дыхание
gasps  -  вздохи
gather  -  собирать
gatsby  -  Гэтсби
gave  -  дал
gear  -  шестерня
gee  -  вот здорово
geek  -  Компьютерщик
gemini  -  Близнецы
generations  -  поколения
gentleman  -  джентльмен
gesomething  -  gesomething
get  -  получить
gets  -  получает
getting  -  получение
gettysburg  -  Геттисберге
ght  -  GHT
giggles  -  хихикает
gilbert  -  Гильберт
gilberts  -  Gilberts
girl  -  девушка
girl's  -  девичий
girlfriend  -  Подруга
girlfriend's  -  подруга
girls  -  девочки
give  -  дайте
given  -  данный
gives  -  дает
giving  -  дающий
glad  -  довольный
glass  -  стакан
gloomy  -  мрачный
gnomes  -  гномы
go  -  идти
god  -  Бог
god's  -  божий
goes  -  идет
going  -  собирается
golden  -  золотой
gone  -  прошло
gonna  -  собирается
gonnae  -  gonnae
good  -  хорошо
goodbye  -  Прощай
goodness  -  доброта
google  -  Google
got  -  получил
gotreal  -  gotreal
gotta  -  должен
gotten  -  полученный
grab  -  грейфер
graces  -  грации
grade  -  класс
grams  -  граммов
grandfather  -  Дед
grandma  -  бабушка
grandpa  -  дедушка
graveyard  -  кладбище
great  -  Великий
greater  -  большая
greatest  -  величайший
greatgreatgrandma  -  greatgreatgrandma
grill  -  гриль
grisham  -  Гришэм
groaning  -  стонущий
groans  -  стоны
ground  -  земля
grounded  -  заземленный
group  -  группа
groveling  -  низкопоклонство
grow  -  расти
growing  -  рост
grown  -  взрослый
grows  -  растет
grunge  -  гранж
grunting  -  хрюканье
grunts  -  хрюкает
guacamole  -  гуакамоле
guard  -  охрана
guardian  -  опекун
guess  -  Угадай
guest  -  гость
guitar  -  гитара
gums  -  десны
gumthere's  -  gumthere-х
gun  -  пистолет
gunshot  -  огнестрельное
guy  -  парень
guy's  -  парень
guys  -  парни
ha  -  ха
habitat  -  естественная среда
had  -  имел
hadn't  -  не имел
hair  -  волосы
hair's  -  HAIR'S
hairline's  -  волосная-х
half  -  половина
hall  -  зал
hallucinations  -  галлюцинаций
hammer  -  молоток
hand  -  рука
handle  -  ручка
handling  -  обращение
hands  -  Руки
handshake  -  рукопожатие
hang  -  вешать
hanging  -  подвешивание
happen  -  случаться
happened  -  получилось
happening  -  происходит
happens  -  происходит
happiness  -  счастье
happy  -  счастливый
happyish  -  happyish
harbinger  -  предвестник
harbor  -  гавань
hard  -  жесткий
harder  -  Сильнее
harm  -  вред
harvard  -  Гарвард
has  -  имеет
hasn't  -  не имеет
hate  -  ненавидеть
hates  -  ненавидит
haunting  -  преследующий
have  -  иметь
haven't  -  не
having  -  имеющий
haze  -  мгла
he  -  он
he'd  -  он
he'll  -  ад
he's  -  он
head  -  глава
headed  -  двуглавый
heading  -  заголовок
headline  -  Заголовок
headphones  -  наушники
healing  -  исцеление
hear  -  заслушивать
heard  -  услышанным
hearing  -  слух
heart  -  сердце
heartbreaker  -  локон
heartbroken  -  убитый горем
heath  -  вереск
heavily  -  сильно
heh  -  хех
height  -  высота
heights  -  высоты
held  -  Ручной
hell  -  ад
hello  -  Здравствуйте
help  -  Помогите
hendrix  -  Hendrix
her  -  ее
herb  -  трава
here  -  Вот
here's  -  вот
heritage  -  наследие
herkey  -  herkey
herne  -  Херн
heroic  -  героический
hers  -  ее
hey  -  Привет
hhow  -  hhow
hi  -  Здравствуй
hidden  -  скрытый
hide  -  скрывать
hideous  -  отвратительный
hiding  -  прячется
high  -  высокая
hill  -  холм
him  -  его
hint  -  намек
his  -  его
historical  -  исторический
history  -  история
hit  -  удар
hitchcock  -  Хичкок
hits  -  хиты
hitting  -  ударять
hmm  -  хмм
hold  -  держать
holding  -  держа
holes  -  отверстия
holy  -  святой
home  -  Главная
homely  -  некрасивый
homemade  -  домашний
homework  -  домашнее задание
homicide  -  убийство
hon  -  хон
honest  -  честный
honestly  -  честно говоря
honey  -  мед
honeybunny  -  honeybunny
honored  -  заслуженный
hooked  -  зацепили
hooking  -  закреплять
hoots  -  тьфу
hope  -  надежда
hoping  -  надеясь
horrible  -  какой ужас
horribly  -  ужасно
horse  -  лошадь
hospital  -  больница
hot  -  горячий
hour  -  час
hour's  -  часе
hours  -  часов
house  -  дом
housewife  -  домохозяйка
housing  -  Корпус
how  -  как
how's  -  как это
however  -  Однако
huddle  -  жаться
huge  -  огромный
huh  -  хм
human  -  человек
human's  -  человек-х
humanity  -  человечество
humor's  -  юмор-х
hundred  -  сто
hungover  -  похмелье
hungry  -  голодный
hunter  -  охотник
hurdler  -  барьерист
hurt  -  причинить боль
hurting  -  больно
hurts  -  болит
hut  -  хижина
hypocrite  -  лицемер
hypothetically  -  гипотетически
i'd  -  Я бы
i'll  -  больной
i'm  -  я
i've  -  я
ibut  -  но я
ice  -  лед
id  -  Я бы
idea  -  идея
ideals  -  идеалы
identified  -  идентифицированный
if  -  если
ignore  -  игнорировать
ihere  -  я здесь
ii  -  б
ii'm  -  ii'm
imagine  -  представить
immortality  -  бессмертие
immunization  -  иммунизация
impact  -  влияние
impatient  -  нетерпеливый
impending  -  предстоящий
implies  -  подразумевает
important  -  важный
impossible  -  невозможно
impress  -  впечатление
impressed  -  впечатленный
impulsive  -  импульсивный
in  -  в
inappropriate  -  несоответствующий
inaudible  -  неслышный
inaugural  -  вступительный
incident  -  инцидент
incomplete  -  неполный
increasing  -  повышение
indifference  -  равнодушие
indistinct  -  невнятный
individualism  -  индивидуализм
infection  -  инфекционное заболевание
influence  -  влияние
information  -  Информация
ingested  -  поглощенный
injected  -  введенный
insane  -  ненормальный
inside  -  внутри
insist  -  настоять
inspiring  -  вдохновляющий
instant  -  мгновенное
instead  -  вместо
instinct  -  инстинкт
insults  -  инсульты
intention  -  намерение
intentions  -  намерения
interest  -  интерес
interesting  -  интересно
internet  -  интернет
interrupt  -  прерывание
into  -  в
invitation  -  приглашение
invite  -  приглашать
invited  -  приглашенный
involved  -  участвует
ipete  -  ipete
ipreviously  -  ipreviously
ireally  -  я действительно
irunning  -  irunning
is  -  является
islands  -  острова
isn't  -  не
issue  -  вопрос
issues  -  вопросы
it  -  Это
it'd  -  это было
it'll  -  это будет
it's  -  его
it'sit's  -  его это
italian  -  итальянский
italy  -  Италия
ithe  -  Ithe
its  -  его
itself  -  сам
ivy  -  плющ
jackpot  -  куш
james  -  Джеймс
jared  -  Jared
jaundice  -  желтуха
jaw  -  челюсть
jenna  -  Дженна
jer  -  жер
jeremy  -  Jeremy
jeremy's  -  Джереми
jerk  -  придурок
jersey  -  Джерси
jitterbug  -  джиттербаг
job  -  работа
jock  -  Джок
john  -  Джон
join  -  присоединиться
joined  -  присоединился
joining  -  присоединение
joins  -  присоединяется
jokes  -  шутки
joseph  -  Джозеф
journal  -  журнал
juan  -  хуан
judged  -  судить
judgey  -  judgey
judgment  -  суждение
jump  -  Прыгать
jumped  -  прыгнули
june  -  июнь
junk  -  барахло
just  -  просто
justagically  -  justagically
justyou  -  только ты
kanye  -  Канье
katherine  -  Katherine
kearney  -  Kearney
keep  -  держать
keeping  -  хранение
keeps  -  держит
kelly  -  келли
kennedy  -  Kennedy
kept  -  хранится
keywords  -  ключевые слова
kick  -  удар
kickoff  -  подать мяч
kid  -  дитя
kidding  -  ребячество
kids  -  Дети
kill  -  убийство
killed  -  убитый
killer  -  убийца
killing  -  убийство
kind  -  своего рода
kinda  -  вроде
kindness  -  доброта
king  -  король
kiss  -  поцелуй
kissing  -  целование
kitchen  -  кухня
kitschy  -  китча
knees  -  колени
knew  -  знал
knock  -  постучать
knocked  -  нокаутировал
know  -  знать
knowing  -  знание
known  -  известен
knows  -  знает
korean  -  Корейский
lack  -  отсутствие
lady  -  леди
lake  -  озеро
lame  -  ламе